Gg, Gg, Gg, Gg, Gg, Gg, Gg, Gg, Gg, Gg, Gg, Gg, Gg, Gg, Gg, Gg, Hh, Hh, Hh, Gg, Hh, Gg
Gg, Gg, Gg, Gg, Gg, Gg, Gg, Gg, Gg, Gg, Gs, Gs, Gg, Gg, Gg, Gg, Ss, Hh, Gg, Hh, Hh, Hh
Gg, Gg, Ds, Gg, Ss, Gg, Ss, Gg, Gs^Fp, Gg, Gs, Gs, Gg, Gg, 4 Ker, Gg, Ss, Ss, Ss, Hh^Vhh, Hh, Gg
Gg, Gg, Ss, Ss, Ss, Ss, Gg, Gs^Fp, Gs^Fms, Gs^Fp, Gg, Gg, Gg, Cer, Cer, Cer, Ss, Ds, Ss, Ss, Ss, Gg
Gg, Gg, Gg, Gg, Gg, Gg, Gg, Gs^Fp, Gs^Fp, Gs^Fp, Ss, Ss, Ss, Ss, Gg, Gg, Gg, Ss, Ss, Gs^Fp, Ss, Gg
Gg, Ss, Cer, 3 Ker, Cer, Gg, Gs^Efm, Gg^Ve, Gs^Fp, Hh, Hh, Ss, Gs^Fp, Gs^Fp, Ss, Ss^Vhs, Gs^Fp, Ss, Gs^Fp, Gs^Fp, Gg, Gg
Gg, Ss, Ss, Cer, Gg, Gg, Gg, Gg, Hh, Hh, Hh, Gs^Fp, Wwrg, Gs^Fp, Ww, Gs, Ss, Gs^Fms, Ss, Gg, Gs^Efm, Gg
Ss, Ss, Gg, Gg, Ss, Gg, Gg, Gg, Gg, Hh, Gs^Fet, Hh, Wwg, Gs^Fms, Ds, Ww, Ss, Wwrg, Ds, Ss, Ss, Gg
Gg, Gg, Gs^Efm, Gg, Ss, Gg, Gg^Ve, Ss, Hh, Hh, Wwg, Wwg, Wwg, Wwg, Gs, Gs, Gs^Fp, Ss, Ww, Ww, Ww, Ss
Gg, Hh, Gg, Gg, Gg, Gg, Gs^Fds, Ss, Ss, Ds, Gs, Wwg, Gs, Ds, Ss, Gs^Fp, Gs^Fp, Gs^Fp, Ss, Ss, Wo, Wo
Gg, Gg, Ww, Ww, Ww, Ww, Ww, Ww, Ww, Gs, Ss, Gs, Ss, Ss, Cme, Ss, Ss, Ss, Wo, Wo, Ss, Gg
Wo, Wwrg, Wo, Wo, Wo, Wo, Wo, Gs^Fds, Ss, Wo, Ss, Ss, Ds, Ss, Wo, Kme, Ww, Ww, Wo, Ww, Ss, Ss
Wo, Wo, Ww, Ww, Ww, Ww, Ww, Gg, Ss, Ww, Wog, Wo, Wo, Wwrg, Ww, Wo, Wo, Wo, Ww, Hh, Hh^Fms, Gg
Gg, Gg, Ds, Gg, Ss, Gg, Ss, Ss, Gg, Gg^Vh, Gg, Ww, Gs^Fp, Gs^Fp, Ww, Gg, Ww, Ww, Gg, Hh, Hh, Hh
Gg, Gg, 1 Gg, Gg, Gg, Gg, Ds, Ss, Ss, Gs^Efm, Ss, Ds, Gs, Ds, Gs^Efm, Gg, Gg, Gg, Gg, Hh, Hh, Gg
Ss, Ss, Gg, Ss, Gs^Fms, Gs^Fp, Gs^Fp, Ss, Re^Gvs, Re^Gvs, Re^Gvs, Ds, Ss, Gs^Efm, Gs, Gg, Ss, Gg, Gg, Hh^Fms, Hh, Gg
Gg, Ss, Ss, Ss, Gs^Fms, Gs^Fp, Re^Gvs, Re^Gvs, Re^Gvs, Re^Gvs, Re^Gvs, Ss, Gs^Efm, Gs^Vh, Ss, Ss, Ss, Gg^Ve, Gs^Fp, Gs^Fms, Gs^Fp, Gg
Gs, Gg, Gs, Ss, Ss, Ss, Re^Gvs, Re^Gvs, Re^Gvs, Re^Gvs, Gs^Efm, Gs^Efm, Ch, Ss, Gs^Efm, Gs^Efm, Gs^Efm, Gg, Ss, Gs^Fp, Rp, Rp
Gg, Gg, Ss, Gs^Wm, Re^Gvs, Re^Gvs, Re^Gvs, Re^Gvs, Ss, Ss, Ds, Ch, 2 Kh, Gg, Gs^Efm, Gs^Efm, Gs^Efm, Ss, Rp, Rp, Re^Gvs, Re^Gvs
Gs, Gs, Re^Gvs, Re^Gvs, Re^Gvs, Re^Gvs, Re^Gvs, Ss, Ss, Ss, Gs^Efm, Gg, Gg^Ecf, Ch, Rp, Gs^Efm, Rp, Rp, Re^Gvs, Re^Gvs, Re^Gvs, Re^Gvs
Gs, Re^Gvs, Re^Gvs, Re^Vc, Re^Gvs, Re^Gvs, Gs, Gs, Ss, Gs^Efm, Gs^Efm, Gg, Gs^Efm, Rp, Rp, Rp, Ss, Re^Gvs, Re^Gvs, Re^Gvs, Re^Gvs, Re^Gvs
Re^Gvs, Gs, Re^Gvs, Re^Gvs, Gg, Gs, Gg, Gs, Gg, Gg, Gg, Gs^Efm, Rp, Rp, Gg, Ss, Gg, Re^Gvs, Re^Gvs, Re^Gvs, Re^Gvs, Re^Gvs
