Mm^Xm, Mm^Xm, Mm^Xm, Mm^Xm, Mm^Xm, Mm^Xm, Mm^Xm, Mm^Xm, Mm^Xm, Mm^Xm, Mm^Xm, Gg, Rr, Gs, Gs, Mm, Mm^Xm, Mm, Mm^Xm, Mm^Xm, Mm^Xm, Mm^Xm, Mm^Xm, Ss, Wo, Wo^Bw\, Wo, Gs^Bw|r, Wo, Ww, Ss, Ss, Ss, Ss, Wwf, Ww, Mm^Xm, Mm^Xm, Mm^Xm, Ss, Mm^Xm, Mm^Xm
Mm^Xm, Mm^Xm, Mm^Xm, Mm^Xm, Mm^Xm, Mm^Xm, Mm^Xm, Mm^Xm, Mm^Xm, Mm^Xm, Mm, Mm^Xm, Mm^Xm, Rr, Rr, Mm^Xm, Mm^Xm, Mm^Xm, Wwrg, Mm, Ss, Mm^Xm, Ss^Bw/, Ss, Wo, Wo, Wo, Wo^Bw\r, Wo^Bw\r, Wo, Chs, Chs, Chs, Gg, Wwf, Wwf, Hh, Mm^Xm, Mm^Xm, Mm^Xm, Mm^Xm, Mm^Xm
Mm^Xm, Mm^Xm, Mm^Xm, Mm^Xm, Mm^Xm, Mm^Xm, Hh, Hh, Hh, Gs, Gs, Mm^Xm, Mm^Xm, Mm^Xm, Rr, Gg, Gg, Ds, Wog, Ch, 5 Khr, Gs^Vht, Ss, Ww^Bw\, Wwg, Wo, Ss, Wo, Wo, Wo^Bw\r, Chs, 4 Khr, Chs, Gg, Wwg, Wwf, Gg, Hh^Fms, Gg, Mm^Xm, Mm^Xm, Mm^Xm
Mm^Xm, Mm^Xm, Hh^Vdt, Mm, Hh, Hh, Hh^Fds, Hh, Hh, Hh, Hh, Mm^Xm, Ds, Gg, Ss, Rr, Rr, Gg, Wog, Ch, Ch, Gs, Wwg, Ww^Ewf, Ss, Ss, Ss, Ss, Wwg, Wo, Wo, Chs, Wo, Ss^Vhs, Wo, Wwg, Gg, Hh, Gg, Mm^Xm, Mm^Xm, Mm^Xm
Mm^Xm, Hh^Fms, Hh, Hh, Hh, Hh, Hh, Hh, Mm^Xm, Mm^Xm, Ss, Wwrg, Ss, Ss, Ss, Ss, Ds, Rr, Wwf, Wwf, Wwf, Ss, Wwg, Ss, Ss, Ss, Gg, Ww^Ewf, Wwg, Wo, Wo, Wo^Bw|r, Wo^Bw\r, Wo, Wwg, Hh, Gg, Hh, Gg, Gg, Mm^Xm, Mm^Xm
Mm^Xm, Mm^Xm, Mm, Hh, Mm, Mm^Xm, Mm, Hh^Dr, Ss, Ss, Ss, Ss, Chs, Ss^Bw/r, Ss, Ss, Ss, Wwg, Ss, Wwg, Wwf, Wwf, Wwg, Ss^Vhs, Wwg, Ss, Wwg, Wwg, Gs, Gs^Fp, Gs^Fp, Wo, Wwg, Wwg^Bw\r, Rd, Wwg, Gg, Hh, Gs^Fp, Gg, Mm^Xm, Mm^Xm
Mm^Xm, Mm^Xm, Mm, Mm^Xm, Mm, Mm, Mm^Xm, Mm^Xm, Ss, Ss, Ss, Chs, 6 Ker, Chs, Ss, Ds, Ds^Uf, Ss, Ss, Wwg, Wog, Wwf, Wwf, Wwf, Wwg, Wwf, Wwf, Gs, Gs, Gs^Fp, Gs^Fp, Gs^Fp, Gs^Fp, Wwg, Rd, Hh, Hh, Hh^Fms, Gs^Fp, Gs^Fp, Gg, Mm^Xm
Gg, Gs^Fp, Mm^Xm, Mm, Mm^Xm, Mm^Xm, Mm^Xm, Ss, Wwg, Ss, Wwg, Wo, Wo, Wwg, Ds, Ss, Ss, Ss, Wwg, Wog, Wog, Ss, Ss, Wwf, Wwf, Wwf, Wwf, Rr, Rr, Gs, Gs^Fp, Gs^Fp, Rd, Rd, Gs^Fp, Rd, Gs, Gg, Gs^Fp, Gg, Rr, Rr
Gs^Fp, Gs^Fp, Mm^Xm, Ds, Ss, Ss, Ww^Ewf, Wwg, Ds^Uf, Wo, Ds, Ss^Vht, Wwg, Wwg, Gg, Gg, Wog, Wog, Wog, Gg^Fetd, Wwg, Wwg, Wwg, Wwg, Wwg, Wwg, Gs^Fp, Gs^Fp, Gs^Fp, Rr, Re, Gs, Gg, Gs^Fp, Gs^Fp, Gg, Gs^Fp, Rd, Rr, Rr, Gg, Gg
Mm^Xm, Mm^Xm, Gg, Ds, Ss, Wwg, Wwg, Ss, Ss, Ss, Ss, Ss, Wog, Wwg, Wog, Wog, Wog, Ss, Gs, Gs, Wwg, Wwg, Wwg, Wwg, Wwg, Wwg, Gs^Fp, Gs^Fp, Gs, Gs^Fp, Rr, Gs^Fp, Gs^Fp, Gs^Fp, Gs^Fp, Gs^Fp, Gg, Gs^Vl, Rr, Gg, Gg, Gg
Gg, Gg, Ss, Ss, Wog, Wog, Ss, Ss, Ds, Ds, Ss, Wog, Wwg, Wog, Wog, Wog, Ss, Ss, Ss, Wwg, Ss, Wwg, Wwg, Gs^Fp, Gs^Fp, Gs^Fp, Gs^Fp, Gs^Fp, Gs^Fp, Gs^Fp, Rr, Gs^Fp, Gs^Fet, Gs^Fp, Gs^Fp, Gs, Rr, Rr, Gg, Gg, Gg, Gg
Ss, Ss, Ss, Wog, Wog, Ss, Ss, Ss, Wo, Ds^Uf, Ss, Ss, Wwg, Ds^Uf, Ss, Ss, Ss, Ss, Ww^Ewf, Wwg, Ss, Gg, Gg, Wwg, Gg, Gs^Fp, Gg, Gs^Fp, Gg^Fet, Gs^Fp, Gs^Fp, Rd, Gs^Fp, Gs^Fp, Gs, Rr, Gg, Gg, Gg, Gg, Gs^Fp, Gg
Ds, Ss, Ss, Wog, Ss, Ss, Wwg, Ww^Ewf, Wwg, Wo, Ww^Ewf, Wwg, Ss, Ds, Ss, Ss, Wwg, Wwg, Ss, Ss, Ss, Gg, Gg, Wwg, Wwg, Gs^Fp, Gs^Fp, Gs^Fp, Gs^Fp, Gs^Fp, Gs^Fp, Gs, Gs, Gs^Fp, Gs, Rr, Gg, Gg, Gg, Gs^Fp, Gg, Gg
Ds, Ds, Wog, Wog, Wwg, Wwg, Gg, Ss, Gg, Wwg, Ds, Ds, Chs, Ss, Ss, Wwg, Wwg, Ss, Ss, Ss, Gg, Gg, Gg, Gg, Gg, Wwg, Wwg, Gg, Gs^Fp, Gs^Fp, Rr, Rd, Gs^Fp, Gs^Fp, Rr, Rr, Gg, Gs^Vl, Gs^Fp, Gs^Fp, Gg, Gg
Wwg, Ss, Ww^Ewf, Wwg, Ss, Ss, Gg, Gg, Gg, Ss, Chs, 3 Khs, Chs, Wwg, Ss, Wwg, Ss, Ss, Gg, Gg, Gg, Gg, Gg, Gs^Vht, Gg, Gg, Wwg, Wwg, Wwg, Gs^Fp, Rr, Gg, Rr, Rr, Gg, Gg, Gs^Fp, Gg, Gs^Fp, Gs^Fp, Gg, Gg
Ss, Wwg, Ss, Ss, Gg, Gg, Gg, Gs^Vc, Gg, Ss, Hh, Chs, Gg, Ss, Gg, Ss, Gg, Gg, Gg, Gg, Gs^Fp, Gg, Gg, Gg, Gg, Gg, Gg, Wwg, Wwg, Gg, Rr, Rr, Gg, Gg, Gs^Fp, Gs^Fp, Gg, Gs^Fp, Gg, Gg, Gg, Gg
Ss, Ss, Gg, Gg, Gs^Fp, Gg, Gg, Gg, Gg, Gg, Ss, Gg, Gg, Gg, Ss, Ss, Gs^Fp, Gs^Fp, Gs^Fp, Gs^Fp, Gg, Gg, Gg, Gg, Gg, Gg, Gg, Wwg, Wwg^Bw/, Wwg^Bw/, Gg, Gg, Gg, Gs^Fp, Gs^Fp, Gs^Fp, Gg, Gs^Fp, Gs^Fp, Gg, Gg, Gg
Gs^Fp, Gs^Fp, Gs^Fp, Gs^Fp, Gs^Fet, Gs^Fp, Gs^Fp, Gg, Gg, Gg, Gg, Gg, Gs^Fp, Ss, Ss, Gs^Fp, Gs^Fp, Gs^Fp, Gs^Fp, Gs^Fp, Hh^Fms, Hh, Hh, Hh, Hh, Gg, Hh, Rr, Gg, Wwg, Wwg, Gg, Gg, Gg, Gg, Gs^Fp, Gg, Gg, Gs^Fp, Gg, Gg, Gg
Gg, Gg, Gs^Fp, Gs^Fp, Gs^Fp, Gs^Fp, Gg, Gg, Gg, Gg, Ss, Ss, Ss, Ss, Ss, Gs^Fp, Gg, Gs^Fp, Gg, Gg, Hh, Hh, Hh, Hh, Mm, Hh, Hh, Rr, Hh, Gg, Gg, Wwg, Gg, Gg, Gg, Gs^Fp, Gg, Gg, Gg, Gs^Fp, Gg, Gg
Gg, Gs^Fp, Gg, Gg, Gg, Gg, Gg, Gg, Gg, Gg, Ss, Ss, Ss, Ss, Gg, Gg, Gg, Gg, Hh, Hh, Hh, Hh, Hh^Vc, Mm, Mm, Mm, Rr, Rr, Gg, Hh, Gg, Wwg, Wwg, Gg, Gg, Gg, Gg, Gg, Gs^Fp, Gs^Fp, Gs^Fp, Gg
Gg, Gg, Gg, Gg, Gs^Fp, Gg, Gg, Gg, Gg, Gg, Gs^Fp, Gg, Gg, Gg, Gg, Gg, Gg, Hh, Hh, Hh, Mm, Mm, Hh, Mm, Rr, Rr, Hh, Hh, Mm, Hh, Gg, Gg, Wwg, Gg, Gg, Gg, Gg, Gg, Gs^Fp, Gg, Gg, Gg
Gg, Gg, Gs^Fp, Gs^Fp, Gg, Gg, Gg, Gg, Gg, Gs^Fp, Gg, Gs^Fp, Gs^Fp, Gs^Fp, Gg, Gg, Gg, Hh, Hh, Hh^Fms, Mm, Mm^Xm, Mm, Rr, Hh, Hh, Mm, Hh^Vc, Hh, Hh, Hh, Gg, Gg, Wwg, Gg, Gg, Gg, Gg, Gs^Fp, Gs^Fp, Gg, Gg
Re^Gvs, Gg, Gg, Gs^Fp, Gg, Gg, Gg, Gg, Re^Gvs, Re^Gvs, Re^Gvs, Gg, Gg, Gg, Gg, Gg, Gs^Vl, Gg, Gg, Hh, Hh, Mm, Rr, Rr, Mm, Mm, Mm, Mm, Hh, Hh, Hh, Gg, Gg, Wwg, Gg, Gg, Mm, Gs^Fp, Gs^Fp, Gs^Fp, Gg, Gg
Re^Gvs, Re^Gvs, Re^Gvs, Gs^Fp, Gs^Fp, Gg, Re^Gvs, Re^Gvs, Re^Gvs, Re^Gvs, Re^Gvs, Gg, Ce, Ce, Ce, Gg, Gg, Gg, Gg, Gg, Rr, Rr, Hh, Hh, Hh, Mm, Hh, Hh, Gg, Hh, Hh, Gg, Gg, Wwg, Gg, Mm, Mm, Hh^Fms, Gs^Fp, Gs^Fp, Gg, Gg
Re^Gvs, Re^Gvs, Re^Gvs, Gg, Gg, Gg, Re^Gvs, Re^Gvs, Re^Gvs, Re^Gvs, Gg, Gg, Ce, 1 Ke, Ce, Gg, Gg, Gg, Rr, Rr, Gg, Hh, Hh, Hh, Hh^Fms, Hh, Hh, Gg, Hh, Hh, Re^Gvs, Re^Gvs, Re^Gvs, Wwg, Wwg, Gg, Gg, Mm, Gg, Gs^Fp, Gg, Gg
Re^Gvs, Re^Gvs, Re^Gvs, Re^Gvs, Gg, Gg, Rr, Re^Gvs, Rr, Rr, Rr, Rr, Rr, Ce, Rr, Rr, Rr, Rr, Re^Gvs, Re^Gvs, Re^Gvs, Hh, Hh, Hh, Hh, Hh, Hh, Hh, Re^Gvs, Re^Gvs, Re^Gvs, Re^Gvs, Re^Gvs, Re^Gvs, Gg, Wwg, Gg, Gg, Ce, Gs^Vl, Gg, Gg
Gg, Re^Gvs, Re^Gvs, Re^Gvs, Rr, Rr, Gg, Rr, Gg, Gg, Gg, Gg, Gg, Rr, Gg, Gs^Vl, Gg, Gg, Re^Gvs, Re^Gvs, Re^Gvs, Gg, Gg, Hh, Hh, Hh, Gg, Gg, Re^Gvs, Re^Gvs, Re^Gvs, Re^Gvs, Re^Gvs, Re^Gvs, Gg, Wwg, Wwg, Ce, 2 Ke, Gg, Gg, Gg
Rr, Gg, Rr, Rr, Gg, Gg, Gg, Gs^Vc, Gg, Gg, Gg, Gg, Gg, Gg, Gg, Gg, Gg, Gg, Gs^Fp, Re^Gvs, Gs^Fp, Gg, Gg, Gg, Mm, Mm^Xm, Mm, Mm, Gg, Re^Gvs, Re^Gvs, Re^Gvs, Mm, Gg, Gg, Gg, Ww^Bw/, Gg, Ce, Ce, Gg, Gg
Gs^Fp, Rp, Gs^Fp, Gs^Fp, Gs^Fp, Gg, Gg, Gg, Gg, Gg, Gg, Gg, Gg, Gg, Gs^Fp, Gg, Gs^Fp, Gs^Fp, Gg, Gg, Gg, Gg, Gg, Gg, Gg, Mm, Gg, Gg, Gg, Gg, Gs^Fp, Gs^Fp, Gs^Fp, Mm, Mm, Gg, Gg, Ww, Gg, Gg, Gg, Gg
Gs^Fp, Gs^Fp, Gg, Gg, Gg, Gs^Fp, Gg, Gg, Gg, Gg, Gs^Fp, Gs^Fp, Gg, Gg, Gs^Fp, Gs^Fp, Gg, Gg, Gg, Gg, Gg, Gg, Gg, Gg, Gg, Gg, Gg, Gg, Gg, Gg, Gs^Fp, Gs^Fp, Gs^Fp, Gs^Fp, Mm, Gg, Gg, Ww, Ww, Gg, Gg, Gg
Gg, Gg, Gg, Gg, Gg, Gg, Gg, Gs^Fp, Gg, Gs^Fp, Gg, Gg, Gg, Gg, Gg, Gg, Ss, Gg, Gg, Gg, Gg, Gg, Gg, Gg, Gg, Gg, Gg, Gg, Gg, Gg, Gg, Gs^Fp, Gg, Gg, Gg, Gg, Gg, Gg, Ww, Gg, Gg, Gg
