Gg, Gg, Gg, Gg, Gg, Gg, Gg, Gg, Gs^Fp, Gg, Gg, Gg, Gg, Gg, Gg, Gg, Gg, Gg, Gg, Gg, Gs^Fp, Gs^Fp, Gs^Fp, Gs^Fp, Gs^Fp, Gg, Ww, Ww, Gs^Fp, Gg, Gg, Gg, Gs^Fp, Uu, Gs^Fp, Gs^Fp, Gs^Fp, Gs^Fp, Gg, Gg, Gs^Fms, Gs^Fms, Gs^Fp, Gs^Fp, Gs^Fp, Gg, Gg, Gg, Gg, Gg, Gs^Fp, Gs^Fp, Gs^Fp, Gs^Fp, Gs^Fp, Gg, Gs^Fp, Gg, Gg, Ql, Ql, Ql, Ql, Ql, Gs, Gs^Fds, Gs^Fds, Gg, Gg, Gg, Gs^Fds
Gg, Gg, Gg, Gg, Gs^Fp, Gg, Gs^Fp, Gs^Fp, Gg, Gs^Fp, Gg, Gg, Gg, Gg, Gg, Gs, Gg, Gs^Fp, Gs^Fp, Gs^Fp, Gg, Gg, Gg, Gg, Gs^Fp, Gs^Fp, Ww, Ww, Gg, Gs^Fp, Gg, Gs^Fp, Gs^Fp, Gs^Fms, Gs^Fp, Gs^Fp, Gs^Fms, Gs^Fp, Gg, Gg, Gg, Gs^Fms, Gs^Fp, Gs^Fms, Gs^Fp, Gs^Fp, Gg, Gg, Gg, Gg, Gs^Fp, Gs^Fms, Gs^Fp, Gs^Fp, Gg, Gs^Fp, Gs^Fms, Gs, Gg, Ql, Gll, Ql, Ql, Ql, Gs, Gs, 1 Ke, Gg, Gg, Gg, Gg
Gg, Gg, Gs^Fp, Gs^Fp, Gs, Gs^Fms, Gg, Gg, Gg, Gg, Gs^Fp, Gs^Fp, Gs^Fp, Gg, Gg, Gg, Gg, Gg, Gg, Gg, Gg, Gg, Gs^Fp, Gs^Fp, Gs^Fp, Ww, Ww, Gg, Gg, Gg, Gg, Gs^Fp, Gg, Gs^Fp, Gs^Fp, Gs^Fp, Gs^Fp, Gs^Fp, Gs^Fp, Gg, Gs^Fp, Gs^Fp, Gs^Fms, Gs^Fp, Gs^Fp, Gg, Gs^Fp, Gg, Gg, Gs^Fp, Gs^Fp, Gs^Fp, Gg, Mm, Gg, Gg, Gs^Fp, Gg, Gd, Ql, Ql, Ql, Ql, Ql, Gs, Ce, Ce, Ce, Gg, Gg, Gg
Gg, Gg, Gs^Fp, Gs, Gs^Fp, Gs^Fp, Gg, Gg, Gs^Fp, Gs, Gs, Gs^Fp, Gs^Fp, Gs^Fp, Gs^Fp, Gg, Gs^Fp, Gg, Gs^Fp, Gg, Gg^Efm, Gg, Gs^Fp, Gs^Fp, Gg, Ww, Ww, Gg, Gg, Gg, Gg, Gg, Gg, Gs^Fp, Gg, Gg, Gg, Gs^Fp, Gs^Fp, Gs^Fp, Gs^Fp, Gs^Fp, Gs^Fp, Gs^Fp, Mm, Mm, Mm, Gg, Mm, Mm, Gg, Gg, Mm, Mm, Gg, Gg, Gs^Fp, Gg, Gd, Ql, Ql, Ql, Ql, Ql, Ql, Gs, Ce, Ce, Gg^Vo, Gg, Gg
Gs^Fp, Gs^Fp, Gs^Fms, Gs^Fp, Gs^Fp, Gg, Gs^Fp, Gs^Fp, Gs^Fp, Gs^Fp, Gs^Fp, Gg, Gg, Gg, Gg, Gs^Fp, Gs^Fp, Gg^Efm, Gs^Fp, Gs^Fp, Gg, Gg, Gs^Fp, Gs^Fp, Gs^Fp, Ww, Ww, Gg, Gg, Gg, Gs^Fp, Gs^Fp, Gs^Fp, Gs^Fp, Cv, Gg, Gg, Gg^Vh, Gg, Mm, Mm, Mm, Hh, Hh, Hh, Mm, Mm, Mm, Mm, Mm, Gg, Mm, Mm, Gg, Gg, Gg, Gs^Fp, Gs, Ql, Ql, Ql, Ql, Ql, Gll, Ql, Gs, Rd, Gg, Gg, Gg, Gg
Gs^Fms, Gs^Fp, Gs^Fp, Gs, Gs^Fp, Gs^Fp, Gg, Gs^Fp, Gg, Gg, Gg, Gg, Cv^Efm, Gs^Fp, Cv^Efm, Gg, Gg, Gs^Fp, Gs, Gs^Fp, Gs^Fp, Gg, Gs^Fp, Gg, Gg, Ww, Ww, Gg, Gs^Fp, Gs^Fp, Gs^Fp, Gs^Fp, Gs^Fp, Gs^Fp, Gg, Cv, Cv, Gg, Gg, Mm, Hh, Hh, Mm, Mm, Rd, Hh, Mm, Mm, Mm, Mm, Mm, Gg, Gs^Fp, Mm, Gs^Fp, Gg, Gg, Gs, Ql, Gll, Ql, Ql, Ql, Ql, Gd, Ql, Rd, Gg, Gg, Gg, Gg
Gg, Gg, Gg, Gs^Fp, Cv^Efm, Cv^Efm, Cv^Efm, Gs^Fp, Gs^Fp, Gg, Gg, Gs^Fds, Gg, Gg, Gg, Gs^Fds, Gg, Gg, Gs^Fp, Gs^Fp, Gg, Gs^Fp, Gs^Fp, Gg, Gs^Fp, Ww, Ww, Gs^Fp, Gs^Fp, Gs^Fp, Gg, Gg, Gg, Gg, Gs^Fp, Kv, Cv, Gg, Gg, Gg, Hh, Mm, Rd, Rd, Mm, Rd, Rd, Mm, Hh, Mm, Gs^Fp, Gs^Fp, Gs^Fp, Gs^Fp, Gs^Fms, Gs^Fp, Gg, Ql, Ql, Ql, Ql, Ql, Ql, Ql, Rd, Rd, Gg, Gg, Gg, Gg, Gg
Gg, Gg, Gs^Fp, Cv^Efm, Cv^Efm, 4 Kv, Cv^Efm, Cv^Efm, Gg, Gg^Ve, Gg, Cv^Efm, Gg, Gg^Fet, Gg, Cv^Efm, Gg, Gg, Gg, Gs^Fp, Gs^Fp, Gs^Fp, Gs^Fp, Gs^Fp, Ww, Ww^Bw\, Gs^Fp, Gs^Fp, Gg, Gg, Gg, Gg, Gg, Gs^Fp, Cv, Cv, Gg, Gg, Gg, Gg, Rd, Rd, Hh, Mm, Mm, Mm, Mm, Rd, Rd, Hh, Hh, Hh, Mm, Gs^Fp, Gg, Gs^Fp, Gg, Ql, Ql, Ql, Ql, Ql, Ql^Bcx/, Rb, Gg, Gg, Gg, Gg, Gg, Gg, Gg
Gg, Gg, Gs^Fp, Gg, Gg^Ve, Cv^Efm, Gs^Fp, Rr, Rr, Gg, Gg, Gs^Fp, Cv^Efm, Gg, Cv^Efm, Gs^Fp, Gg, Gg, Gs^Fp, Gs^Fp, Gg, Gs^Fp, Gg, Ww, Ww, Ww, Gg, Gg, Gs^Fp, Gg, Rd, Gg, Rd, Gs^Fp, Gg, Gg, Gg^Vh, Gg, Rd, Rd, Hh, Hh, Mm, Mm, Mm, Mm, Mm, Hh^Vc, Hh, Rd, Rd, Mm, Rd, Mm, Mm, Gg, Gd, Ql, Ql, Ql, Ql^Bcx/, Ql^Bcx/, Ql, Ql, Gg, Ql, Ql, Gg, Gg, Gg, Gg
Gg, Gg, Gs^Fp, Gg, Gg, Gg, Gs^Fp, Gg, Gg^Ve, Rr, Rr, Gg, Gg, Gs^Fds, Gg, Gg, Gs^Fms, Gs^Fp, Gs^Fms, Gs^Fp, Gg^Efm, Gs^Fp, Gg, Ww, Ww, Ww, Gs^Fp, Gs^Fp, Gs, Rd, Gg, Rd, Gg, Rd, Rd, Rd, Rd, Rd, Hh, Hh, Hh, Hh, Mm, Mm, Mm, Mm, Mm, Hh, Hh, Mm, Mm, Rd, Mm, Rd, Mm, Gs, Ql, Ql, Ql^Bcx/, Ql^Bcx/, Ql, Ql, Ql, Ql, Rb, Ql, Gg, Gg, Gg, Gg, Gg
Gg, Gg, Gs^Fp, Gs^Fms, Gs^Fp, Gs^Fp, Gg, Gg, Gs^Fp, Gg, Gg, Rr, Rr, Gg, Gg, Gg, Gg, Gs^Fp, Gg, Gg, Gs^Fp, Gs^Fp, Gg^Ve, Ww, Gg, Gg, Rd, Gs, Rd, Rd, Gg, Gg, Gg, Gs^Fp, Gs^Fp, Gg, Gg, Gg, Gg, Hh, Gg, Mm, Mm, Mm, Mm, Mm, Mm, Gs^Fp, Gs^Fp, Mm, Mm, Mm, Mm, Rd, Rd, Rd, Rb, Urb, Ql, Ql, Ql, Ql, Ql^Bs/, Ql^Bs/, Ql, Ql, Gg, Gg, Gg, Gg, Gg
Gg, Gg, Gs^Fp, Gs^Fp, Gg, Gs^Fp, Gs^Fp, Gs^Fp, Gs^Fp, Gs^Fp, Gs^Fp, Gs^Fp, Gs^Fms, Rr, Rr, Gg, Gg, Gg, Gg, Gg, Cv^Efm, Gs^Fp, Gg, Ww, Ww^Bsb/, Rd, Gg, Rd, Gg, Gg, Gs^Fp, Gg, Gg, Gs^Fp, Gs^Fms, Gg, Gg, Gg, Gg, Gg, Mm, Gg, Gg, Gg, Gg, Gg, Gg, Gg, Gs^Fp, Mm, Gg, Mm, Ss, Gs, Gg, Gs, Ql, Ql, Ql, Rb, Rb, Ql^Bs/, Ql, Ql, Ql, Gd, Gg, Gg, Gg, Gg, Gg
Gg, Gg, Gs^Fms, Gs^Fp, Gs^Fp, Gs^Fp, Gs^Fp, Gs^Fp, Gs^Fp, Gs^Fms, Gg, Gg, Gg^Efm, Gs^Fp, Gg, Rr, Rr, Gg, Rr, Cv^Efm, Kv, Cv^Efm, Rr, Rr, Gg, Ww, Ww, Gg, Ww, Gs^Fp, Gg, Gg, Gg, Gs^Fp, Gs^Fp, Gs^Fp, Gg, Gg, Mm, Mm, Gg, Mm, Gg, Gg, Gs^Fp, Gg, Gs^Fms, Gs^Fp, Ss, Gg, Ss, Gg, Ss, Ss, Gs, Gg, Ql, Ql, Rb, Ql, Ql, Ql, Ql^Bs/, Rb, Ql, Ql, Gg, Gg, Gg, Gg, Gg
Gs^Fp, Gs^Fp, Gg, Gs^Fp, Gg, Gs^Fms, Gs^Fp, Gs^Fms, Gs^Fp, Gs^Fp, Gs^Fp, Gs^Fp, Gs^Fms, Gg, Gg, Gg^Vc, Rr, Rr, Gg, Rr, Rr, Rr, Gg, Gg, Gg, Gg, Gs^Fp, Ww, Ww, Gg, Gg, Gs^Fp, Gs^Fp, Gg, Gs^Fp, Gg, Gg, Mm, Gg, Gg, Gs^Fp, Gs^Fp, Gs^Fp, Gs, Ss, Gs^Fp, Ss, Ss, Ss, Ss, Ss, Ss, Ss, Ss, Gs, Gg, Gd, Ql^Bs/, Ql, Ql^Bs\, Rb, Ql^Bs/, Ql, Ql, Gd, Ql, Gg, Gg, Gg, Gg, Gg
Gs^Fp, Gg, Gg, Gg, Gs^Fp, Gs^Fp, Gs^Fms, Gs^Fp, Gg, Gs^Fp, Gs^Fp, Gg, Gs^Fp, Gs^Fp, Rr, Rr, Gg^Efm, Gg, Gg, Gg, Gg, Gg, Gg, Gg, Gs^Fp, Gs^Fp, Gg, Ww, Ww, Ww, Ww, Gs^Fp, Gg^Efm, Gg, Gg, Gs^Fp, Gg, Gg, Gg, Gg, Gg, Gs^Fp, Gs, Gs^Fp, Ss, Ss, Ss, Ss, Gg, Ss, Gg, Gg, Gg, Ss, Gg, Gd, Ql, Gd, Ql, Ql, Ql^Bs|, Ql, Ql, Ql, Gg, Gg, Gg, Gg, Gs^Fp, Gg, Gg
Gg, Gs^Fp, Gs^Fp, Gs^Fp, Gs^Fms, Gs^Fp, Gs^Fms, Gs^Fp, Gs^Fp, Gs^Fp, Gs^Fp, Gs^Fp, Rr, Rr, Gg, Gs^Fp, Gs^Fp, Gs^Fp, Gs^Fp, Gg, Gg, Gg, Gg, Gs^Fp, Gs^Fp, Gg, Gg^Ve, Gg, Gg, Ww, Ww, Gg, Gs^Fp, Gs^Fp, Gs^Fp, Gs^Fp, Gg, Gg^Vh, Gg, Gg, Gg, Gs, Ss, Ss, Ss, Ss, Ss, Gs, Gg^Vht, Gg, Gs^Fp, Gg, Ce, Gg, Gs, Gd, Gd, Gd, Ql, Ql, Rb, Ql, Ql, Ql, Gd, Gg, Gg, Gg, Gs^Fms, Gg, Gg
Gs^Fp, Gs^Fp, Gs^Fp, Gs^Fp, Gs^Fp, Gs^Fp, Gs^Fp, Gs^Fp, Gg, Gs^Fp, Rr, Rr, Gs^Fp, Gg, Gg, Gg, Gs^Fp, Gs^Fms, Gg, Gs^Fp, Gs^Fp, Gg, Gs^Vc, Gs^Fp, Gg, Gg, Ce, Gg, Gg, Ww, Ww, Gs^Fp, Gs^Fp, Gs^Fms, Gs^Fp, Gs^Fp, Gg, Gg, Gs^Fp, Gs^Fp, Gs^Fp, Gs^Fp, Ss, Gs^Fp, Gs^Fp, Gg, Ss, Ss, Gg, Gs^Fp, Gg, Ce, 2 Ke, Ce, Gg, Ql, Ql, Ql, Rb, Ql^Bs/, Ql, Ql, Ql, Ql, Ql, Gg, Gs^Fp, Gg, Gs^Fp, Gg, Gg
Gg, Gg, Gg, Gg, Gs^Fp, Gs^Fp, Gg, Gs^Fp, Rr, Rr, Gs^Fp, Gs^Fp, Gs^Fp, Gs^Fp, Gs^Fp, Gs^Fp, Gs^Fp, Gg, Gs^Fp, Gg^Efm, Gg, Gg, Gg, Gs^Fp, Gg, Ce, 3 Ke, Ce, Gg, Gg, Ww, Gg, Gg, Gg, Gg, Gg, Gg, Gg, Gg, Gg, Gs, Ss, Ss, Gs^Fp, Ss, Ss, Ss, Ss, Ss, Gs^Fp, Gg, Ce, Ce, Ce, Gg, Gg, Ql, Ql, Rb, Ql, Ql, Ql, Ql, Ql, Ql, Gg, Gs^Fms, Gs^Fp, Gg, Gg, Gg
Gg, Gs^Fp, Kh, Gs^Fp, Ch, Gg, Rr, Rr, Gs^Fp, Gs^Fp, Gs^Fms, Gs^Fp, Gg^Efm, Gg, Gg, Gg, Gg, Gs^Fp, Gs^Fms, Gs^Fp, Gs^Fp, Gg, Gg, Gs^Fp, Gg, Ce, Ce, Ce, Gg, Gg, Gg, Gg, Gg, Gg, Gg, Gg, Gs^Fp, Gs^Fp, Gs^Fp, Gg, Gs^Fp, Gs^Fp, Ss, Ss, Ss, Ss, Ss, Ss, Ss, Gg, Ss, Gg, Gg, Gg, Gg, Gd, Ql, Ql, Ql, Ql^Bs\, Rb, Rb, Ql, Ql, Gd, Gg, Gs^Fp, Gg, Gg, Gg, Gg
Gg, Ch, Ch, Ch, Rr, Rr, Gs^Fp, Gs^Fp, Gs^Fms, Gs^Fp, Gs^Fp, Gs^Fms, Gs^Fp, Gg, Gs^Fp, Gs^Fms, Gs^Fp, Gs^Fp, Gg^Efm, Gg, Gs^Fp, Gs^Fp, Gg, Gg, Gg, Gg, Gg, Gg, Gg, Gg, Gg, Gg, Gg, Gg, Gg, Gg, Gs^Fp, Gs^Fms, Gs^Fp, Gg, Ss, Gg, Ss, Ss, Ss^Vhs, Ss, Ss, Ss, Ss, Ss, Ss, Ss, Ss, Gg, Gg, Ql, Ql, Ql, Ql, Ql, Ql, Ql^Bs\, Ql^Bs\, Ql, Gg, Gg, Gg, Gg, Gg, Gg, Gg
Gg, Ch, Rr, Rr, Gg, Gg, Gg^Efm, Gs^Fp, Gg, Gs^Fp, Gg, Gs^Fp, Gs^Fp, Gs^Fp, Gg, Gs^Fp, Gg, Gg, Gs^Fp, Gs^Fp, Gg, Gs^Fp, Gg, Gg, Gg, Gg, Gg, Gg, Gg, Gg, Gg, Gg, Gg, Gg, Gg, Gg, Gs^Fp, Gs^Fp, Gg, Gg, Gg, Ss, Gg, Ss, Ss, Ss, Ss, Ss, Ss, Ss^Vhs, Ss, Ss, Ss, Ss, Gg, Gd, Ql, Ql, Ql, Ql, Ql, Ql, Ql, Gg, Gg, Gg, Gg, Gg, Gg, Gg, Gg
Rr, Rr, Gg, Gg, Gg, Gg, Gg, Gg, Gg, Gg, Gg, Gg, Gg, Gg, Gg, Gg, Gg, Gg, Gg, Gg, Gg, Gg, Gg, Gg, Gg, Gg, Gg, Gg, Gg, Gg, Gg, Gg, Gg, Gg, Gg, Gg, Gg, Gg, Gg, Gg, Gg, Gg, Gg, Gg, Gg, Ss, Ss, Ss, Ss, Ss, Gg, Ss, Gg, Ss, Gg, Gg, Ql, Ql, Ql, Ql, Ql, Ql, Gg, Gg, Gg, Gg, Gg, Gg, Gg, Gg, Gg
