Gg, Gg, Gg, Gg, Gg, Ds, Ww, Wo, Wo, Wo, Ww, Ds, Gg, Gg, Gg, Gg, Gg, Gg, Gg, Gg, Gg, Gg, Gg, Gg, Gg, Gg, Gg, Gg, Gg, Gg, Gs^Fp, Gs^Fp, Rr, Rr, Gs^Fp, Gg, Gg, Gg, Gg, Gg, Gg, Gg, Gg, Ww, Gg, Gg, Gg, Gg
Gg, Gg, Gg, Gg, Gg, Ds, Ww, Wo, Wo, Wo, Ww, Ds, Gs^Fp, Gg, Gg, Gg, Gg^Fet, Gg, Gs^Fp, Gs^Fp, Gs^Fp, Gs^Fp, Gg, Gg, Gg, Gg, Gg, Gg, Gs^Fp, Gs^Fp, Rr, Rr, Gs^Fp, Gs^Fp, Gs^Fms, Gs^Fp, Gg, Gg, Gg, Gg, Gg, Gg, Ww, Ww, Gg, Gg^Fet, Gg, Gg
Gg, Gg, Gg^Fet, Gg, Gg, Ds, Ww, Ww, Wo, Wo, Ww, Gg, Gg, Gs^Fms, Gg, Gg, Gg^Ve, Gg, Gs^Fp, Gs^Fms, Gs^Fp, Gs^Fp, Gg, Gg^Fet, Gg, Gg, Gs^Fp, Gs^Fp, Rr, Rr, Gs^Fp, Gs^Fp, Gs^Fp, Gs^Fp, Gs^Fp, Gs^Fp, Gg, Gg^Fet, Gg, Gg, Gg, Gg, Ww, Gg, Gg, Gg, Gg^Fet, Gg
Gg, Gg, Gg, Gg, Gs^Fp, Gg, Ww, Ww, Wo, Wo, Ww, Gg, Gg, Gs^Fp, Gg, Gg, Ce, Gg, Gg, Gs^Fp, Gs^Fp, Gs^Fp, Gg, Gg, Gg, Gg, Gg, Gg, Rr, Gg, Gg, Gs^Fp, Gs^Fp, Gs^Fms, Gs^Fp, Gs^Fp, Gg, Gg, Gg, Gg, Gg^Ve, Gg, Gg, Ww, Gg, Gg, Gg, Gg
Gg, Gg, Gg, Gs^Fms, Gs^Fp, Gs^Fp, Ww, Ww, Wo, Wo, Ww, Ds, Rd^Ve, Gg, Ce, Gs, Ce, Gs, Ce, Gs^Fp, Gs^Fms, Gs^Fp, Gs^Fp, Gg, Gs^Fp, Gg, Gg, Gg, Rr, Gg, Gg, Gg, Gg, Gs^Fp, Gs^Fp, Gg, Gs^Fp, Gs^Fp, Gs^Fp, Gg, Gg, Gg, Gg, Ww^Bw\, Gg, Gg, Gg, Gg
Gg, Gs^Fp, Gs^Fp, Gs^Fp, Gs^Fp, Gs^Fp, Ww, Ww, Wo^Bw/r, Ww^Bw/r, Ds^Bw\r, Ds, Rd, Gg, Gs^Ecf, Ce, 6 Ke, Ce, Gs, Gs^Fp, Gs^Fp, Gs^Fp, Gs^Fp, Gs^Fp, Gg^Efm, Gg, Gg, Gg, Rr, Gg^Fet, Gg, Gg, Gg, Gg, Gg^Ve, Gs^Fms, Gg, Ce, Gg, Gg, Gg, Gg, Ww, Ww, Gg, Gg, Gs^Fp, Gg
Gs^Fp, Gs^Fp, Gs^Fp, Gs^Fms, Gs^Fp, Gg, Ww^Bw/r, Ww^Bw/r, Wo, Ww, Ww, Rd, Gg, Gg, Ce, Ce, Ce, Ce, Ce, Gs^Fms, Gs^Fp, Gs^Fms, Gg, Gg, Gg, Gg, Gg^Fet, Gg, Rr, Gg, Gg, Gg, Gg, Gg, Gg, Ce, Ce, Ce, Ce, Ce, Gg, Gg, Ww, Gg, Gg, Gg, Gs^Fms, Gg
Gs^Fp, Gs^Fms, Gs^Fp, Gs^Fp, Rd, Rd, Ww, Ww, Wo, Wo, Ww, Ds, Gg^Fet, Gg, Gg, Gs, Ce, Gs, Gs^Fp, Gs^Fp, Gs^Fp, Gg, Gg^Fet, Gg, Gg, Gs^Fp, Gg^Efm, Gg, Rr, Gg, Gg, Gg^Fet, Gg, Gg, Gg, Gg, Ce, 7 Ke, Ce, Gs, Gg^Ve, Gg, Ww, Gg, Gg^Fet, Gg, Gs^Fp, Gs^Fp
Gs^Fp, Gs^Fp, Gs^Fp, Gs^Fp, Rd, Ds, Ww, Ww, Wo, Wo, Ww, Gg, Gg, Gg, Gg, Gg, Gg, Gs^Fms, Gs^Fp, Gs^Fp, Gg, Gg, Gg, Gg, Gg, Gs^Fp, Gg, Gs^Fp, Rr, Gg, Gs^Fp, Gs^Fp, Gs^Fp, Gs^Fp, Gs^Fp, Ce, Gs, Ce, Gg, Ce, Gg, Gg, Gg, Ww, Gg, Gg, Gg, Gg
Gg, Gs^Fms, Gg, Gg, Rd, Ds, Ww, Wo, Wo, Wo, Wo, Ww, Ds, Gg^Ve, Ds, Gg, Gg, Gs^Fp, Gs^Fms, Gs^Fp, Gs^Fp, Gg, Gg, Gg, Gg^Efm, Gg, Gs^Fp, Gs^Fp, Rr, Gs^Fp, Gs^Fp, Gs^Fms, Gs^Fp, Gs^Fp, Gs^Fp, Gs^Fms, Gs^Fms, Ce, Gs^Fms, Gg, Gg^Fet, Gg, Gg, Ww, Gg, Gg, Gg, Gg
Gg, Gg, Gg, Gg^Fet, Rd, Gg, Ww, Ww, Wo, Wo, Wo, Ww, Ww, Ds, Ww, Ww, Ww, Ds, Ds, Gs^Fp, Gg, Gs, Gs^Fp, Gs^Fp, Gs^Fp, Gs^Fp, Gs^Fp, Gs^Fp, Rr, Gg, Gs^Fp, Gs^Fp, Gs^Fp, Gs^Fp, Gs^Fp, Gs^Fp, Gs^Fp, Gs^Fp, Gs^Fp, Gs^Fp, Gg, Gg, Gg, Ww, Ww, Gg, Gg, Gg
Ww, Gg, Ww, Gg, Ww, Rd, Gg, Ww, Ww, Wo, Wo, Wo, Wo, Wo, Wo, Wo, Wo, Ww, Ww, Gg, Gg, Gg, Gs^Fp, Gs^Fp, Gs^Fp, Gs^Fp, Gs^Fp, Gs^Fp, Rr, Gg^Vc, Gg, Gg, Gg, Gg, Gg^Fet, Gs^Fp, Gs^Fp, Gs^Fms, Gs^Fp, Gs^Fp, Gg, Gg, Gg, Gg, Ww, Gg, Gg, Gg
Gg, Ww, Gg, Ww, Gg, Wwf, Ww, Ww, Ww, Ww, Ww, Wo, Ww, Wo, Ww, Wo, Wo, Wo, Wo, Ww, Ww, Gg, Ds, Gs^Fms, Gs^Fp, Gs^Fp, Gs^Fp, Gg, Rr, Gg, Gg^Fet, Gg, Gs^Fp, Gs^Fp, Gs^Fp, Gs^Fp, Gs^Fp, Gs^Fp, Gg, Gg, Gg, Gg, Ww^Bw\, Ww, Gg, Gg, Gg^Fet, Gg
Gg, Gg, Gg, Gg, Gg^Fet, Gg, Gg, Gg, Gg, Ds, Ds, Ww, Gg, Ww, Ww, Ww, Wo, Wo, Wo, Wo, Wo, Ww, Gg, Gg, Gs^Fp, Gs^Fp, Gs^Fp, Gg^Fet, Rr, Gg, Gs^Fp, Gg, Gs^Fp, Gs^Fp, Gs^Fms, Gs^Fp, Gs^Fp, Gg, Gg^Fet, Gg, Gg, Ww, Gg, Gg, Gs^Fp, Gs^Fp, Gs^Fp, Gg
Gg, Gg, Gs^Fp, Gs^Fp, Gg^Edb, Gg, Gg^Ve, Ce, Ce, Ce, Gg, Gg^Esd, Ds, Gg, Ww, Ww, Wo, Wo, Wo, Wo, Wo, Ww, Ww, Gg, Gg, Gs, Gs^Fp, Gs^Fp, Rr, Gs^Fp, Gs^Fms, Gs^Fp, Gg, Gs^Fp, Gs^Fp, Gs^Fp, Gs^Fp, Gg, Gg, Gg, Ds, Ww, Gg, Gg, Gs^Fp, Gs^Fp, Gs^Fp, Gg
Gg, Gg, Gs^Fp, Gs^Fms, Gg, Gg, Ce, Ce, Ce, 5 Ke, Ce, Ce, Wwr, Ww, Ww, Wo, Wo, Wo, Wo, Wo, Wo, Wo, Ww, Gg, Gg, Gg, Rr, Rr, Rr, Gs^Fp, Gs^Fms, Gs^Fp, Gg, Gg, Gg, Gs^Fp, Gs^Fms, Gs^Fp, Gg, Ds, Ww, Ww, Gg, 1 Gg, Gg^Fet, Gs^Fp, Gg, Gg
Gg, Gg, Gg, Gg, Ce, Gg, Gg, Gg, Ce, Gg, Gg, Ds, Ww, Ww, Ww, Wo, Wo, Wo, Wo, Wo, Wo, Wo, Wo, Ww, Wwr, Cv^Efm, Ww^Bsb|, Wwr, Ww^Bsb|, Cv^Efm, Ds, Gg, Gg, Gg^Fet, Gg, Gs^Fp, Gs^Fp, Gs^Fp, Gg, Wwr, Ds, Gg, Gg, Gg, Ds, Ds, Ds, Gg
Gg, Gg, Ce, Ce, Gg^Ecf, Gg, Gg^Ve, Gg, Gg^Edb, Gg, Gs^Fms, Ds, Gg, Ww, Gg^Efm, Ww, Ww, Wo, Ww, Ww, Ww, Wo, Wo, Ww, Ww, Ww, Ww^Bsb|, Ww, Ww^Bsb|, Ww, Ww, Ds, Gg, Gg, Ds, Gg, Ds, Ds, Ww, Ww, Gg, Gg, Gg, Gg, Ww, Ww, Wo, Ww
Gg, Ce, Ce, 4 Ke, Ce, Ce, Gg, Gg, Gg, Gg, Ww, Gs^Fms, Ww, Gg, Ww, Ww, Ww, Ww, Gg, Ds, Gg, Ww, Ww, Wo, Wo, Wo, Wo^Bsb|, Wo, Wo^Bsb|, Ww, Wo, Ww, Ww, Ww, Ww, Ww, Ww, Ww, Wo, Ww, Ww, Ww, Ww, Ww^Bw|, Wo, Wo, Wo, Wo
Gg, Gg^Edb, Ce, Ce, Ds, Ds, Wwr, Gg^Fet, Ww, Ww, Wo, Ww, Gg, Ww^Bw|, Gg, Gg, Gg, Gg, Gg, Gg, Gs^Fp, Ds, Ds, Ww, Ww, Wo, Ww^Bsb|, Wo, Ww^Bsb|, Wo, Wo, Wo, Wo, Wo, Wo, Wo, Wo, Wo, Wo, Wo, Wo^Vm, Wo, Wo, Wo^Bw|, Wo, Wo, Ww, Ww
Gg, Gg, Ds, Gg, Gg, Wo, Ww, Ww, Wo, Wo, Ds, Ds, Rd, Rd, Gg, Gg, Gg, Gg, Gs^Fp, Gs^Fp, Gs^Fms, Gs^Fp, Gs^Fp, Ww, Ww, Ww, Ww^Bsb|, Ww, Ww^Bsb|, Ww, Ww, Wo, Ww, Wo, Ww, Wo, Wo, Wo, Wo, Wo, Ww, Wo, Ww, Wo^Bw|, Ww, Ww, Ds, Ds
Ds, Ds, Wwf, Ww, Wo, Wo, Ww, Ww, Ww, Ww, Cv, Cv, Cv, Gs^Fp, Gs^Fp, Gg, Gg, Gg^Fet, Gs^Fp, Gs^Fp, Gs^Fp, Gs^Fp, Gs^Fp, Gg, Gg, Cv^Efm, Rr, Cv^Efm, Rr, Cv^Efm, Ds, Ww, Gg, Ww, Gg, Ww, Ww, Wo, Ww, Ww, Ww, Ww, Ww, Ww^Bw|, Ds, Ds, Gg, Gg
Wwf, Wwf, Gg, Ww, Ww, Ww, Ww, Gg^Fet, Gg, Gs^Fp, Cv, 3 Kv, Cv, Gg^Ve, Gs^Fp, Gs^Fp, Gg, Gg, Gg, Gs^Fms, Gs^Fp, Gs^Fp, Gg, Gg, Gg^Ve, Gg, Rr, Rr, Gs^Fp, Gg, Gg, Ds, Gg, Ds, Gg, Ww, Ww, Ww, Wwr, Ww, Gg, Ww, Gg, Rd, Gg, Gg, Gg, Gg
Ds, Gg, Gg^Fet, Ds, Ds, Ww, Ww, Ww, Ww, Gg, Gg, Cv, Rd, Gs^Fp, Gg, Gg, Gg, Gg^Efm, Gg, Gs^Fp, Gg, Gg^Fet, Gg, Gg, Rr, Rr, Gs^Fp, Gs^Fp, Gs^Fms, Gs^Fp, Gs^Fp, Gg, Gs^Fp, Gg, Gg, Gg, Gg, Ww, Ww, Ww, Ds, Gg, Gs^Vc, Rd, Gg, Gg, Gg, Gg
Gg, Gg, Gg, Gg, Gg, Ds, Ds, Ww, Ww^Bw/, Ww^Bw/, Ww, Gg, Gg, Rd, Rd, Gg^Fet, Gs^Fp, Gg, Gg, Gg, Gg, Gg, Rr, Rr, Gs^Fp, Gs^Fp, Gs^Fp, Gs^Fp, Gs^Fp, Gs^Fp, Gs^Fp, Gs^Fp, Gs^Fp, Gs^Fp, Gs^Fp, Gg^Ve, Gg, Ds, Ds, Wwr, Gg, Gg, Rd, Gg, Ce, Gs^Fp, Gs^Fp, Gg
Gg, Gg, Rd, Gg, Gg, Gg, Gg, Gg, Ww, Ww, Gs^Fet, Ww, Ww, Gg^Ebn, Rd, Gs, Gg^Ve, Gs^Fp, Gs^Fp, Gg, Rr, Rr, Gs^Fp, Gg, Gs^Fp, Gs^Fp, Gs^Fp, Gs^Fp, Gs^Fms, Gs^Fp, Gs^Fms, Gs^Fp, Gs^Fp, Gs^Fp, Gs^Fp, Gg, Gs^Fp, Gg, Gg, Ww, Ww^Bw/, Rd, Gg, Gg, Ce, Ke, Gs^Fp, Gg
Gg, Gg, Rd, Gg^Fet, Gg, Gg, Ww, Ww, Gs^Fet, Gs^Fet, Cv^Efm, Gs^Fet, Gs^Fet, Ww, Ww, Gs, Gs, Gs^Fp, Rr, Rr, Gg^Ve, Gs^Fp, Gs^Fp, Gs^Fp, Gs^Fp, Gs^Fp, Gs^Fms, Gs^Fp, Gs^Fp, Gs^Fp, Gs^Fp, Gs^Fp, Gs^Fp, Gs^Fp, Gs^Fp, Gg^Efm, Gs^Fp, Gs^Fp, Gs^Fp, Gg, Gg, Ww, Ww, Ww, Ss, Ce, Gg, Gg
Gg, Gg, Gs^Fp, Rd, Ww^Bsb\, Ww, Gs^Fet, Gs^Fet, Cv^Efm, Gs^Fet, Cv^Efm, Cv^Efm, Cv^Efm, Gs^Fet, Gs^Fet, Ww, Ww^Bsb/, Rr, Gg, Gg, Gg, Gs^Fp, Gs^Fp, Gs^Fp, Gs^Fp, Gs^Fp, Gs^Fp, Gs^Fp, Gs^Fms, Gs^Fp, Gs^Fp, Gs^Fms, Gs^Fp, Gg^Fet, Gg^Fet, Gs, Gs^Fp, Gs^Fp, Gs^Fp, Gg, Gs, Gg, Gg, Gg, Gs^Fp, Ss, Ww, Ww
Gg, Gg, Gs^Fms, Gg, Ww, Rp, Cv^Efm, Cv^Efm, Gs^Fet, Gg^Ve, Kv, Gs^Fet, Gs^Fet, Cv^Efm, Cv^Efm, Rp, Ww, Gg, Gs^Fp, Gs^Fp, Gs^Fp, Gg, Gs^Fp, Gg, Gg^Ve, Gs^Fp, Gs^Fp, Gs^Fp, Gs^Fp, Gs^Fp, Gs^Fp, Gs^Fp, Gs^Fp, Gg, Gg, Gs^Fp, Gs^Fp, Gs^Fms, Gs^Fp, Gs^Fp, Gs^Fp, Gs^Fp, Gs^Fp, Gs^Fp, Gs^Fp, Gs^Fp, Gg, Gg
Gg, Gs^Fp, Gg^Efm, Gg, Ww, Gs^Fet, Cv^Efm, Rp, Kv, Cv^Efm, Rp^Efm, Rp^Efm, Kv, Rp, Cv^Efm, Gs^Fet, Ww, Gg, Gs^Fp, Gs^Fp, Gs^Fp, Gs^Fp, Gg, Gg, Gs^Fp, Gs^Fp, Gg, Gg^Fet, Gg, Gg, Gg, Gs^Fp, Gg, Gg, Gg, Gg, Gs^Fp, Gs^Fp, Gs^Fp, Gs^Fp, Gs^Fp, Gs^Fms, Gs^Fp, Gs^Fp, Gs^Fp, Gs^Fp, Gg^Fet, Gg
Gg, Gs^Fms, Gg, Gg, Ww, Gs^Fet, Cv^Efm, Gs^Fet, Cv^Efm, Rp^Efm, 2 Kv, Cv^Efm, Cv^Efm, Gg^Ve, Cv^Efm, Gs^Fet, Ww, Gs^Fp, Gs^Fp, Gs^Fms, Gs^Fp, Gs^Fp, Gg, Gg, Gg, Gg, Gg, Gg, Gs^Fp, Gs^Fp, Gs^Fp, Gg, Gg^Fet, Gg, Gs^Fp, Gs^Fp, Gg, Gg, Gg, Gs^Fp, Gs^Fp, Gs^Fp, Gs^Fp, Gs^Fms, Gs^Fp, Gg^Fet, Gg, Gg
Gg, Gs^Fp, Gg, Gg, Ww, Gs^Fet, Cv^Efm, Gs^Fet, Kv, Rp^Efm, Rp^Efm, Rp^Efm, Kv, Gs^Fet, Cv^Efm, Gs^Fet, Ww, Gs^Fp, Gs^Fms, Gs^Fp, Gg, Gg, Gg^Ve, Gg^Efm, Gg, Gg^Fet, Gs^Fp, Gs^Fp, Gs^Fp, Gs^Fp, Gs^Fp, Gs^Fp, Gs^Fp, Gg, Gg, Gg^Ve, Gg, Gg, Gg, Gg^Fet, Gg, Gs, Gs^Fp, Gs^Fp, Gs^Fms, Gs^Fp, Gs^Fp, Gg
Gs^Fp, Gg, Gg, Gg, Ww, Gs^Fet, Cv^Efm, Rp, Gs^Fet, Cv, Kv, Cv^Efm, Gs^Fet, Rp, Cv^Efm, Gs^Fet, Ww, Gs^Fp, Gs^Fp, Gs^Fp, Gs^Fp, Gg, Gg, Gg, Gg, Gg, Gs^Fp, Gs^Fms, Gs^Fp, Gs^Fms, Gs^Fp, Gs^Fp, Gs^Fp, Gg, Gg, Gg, Cvr^Efm, Cvr^Efm, Cvr^Efm, Gg, Gg, Gg, Gg, Gg, Gg, Gs^Fp, Gs^Fp, Gg
Gs^Fp, Gg, Gs^Fp, Gg, Ww^Bsb/, Rp, Gs^Fet, Cv^Efm, Cv^Efm, Gg^Ve, Gs^Fet, Gs^Efm, Cv^Efm, Cv^Efm, Gs^Fet, Rp, Ww^Bsb\, Gs^Fp, Gg, Gs^Fp, Gg, Gs^Fp, Gs^Fp, Gs^Fp, Gg, Gg, Gs^Fp, Gs^Fp, Gg, Gs^Fp, Gg, Gg, Gg^Ve, Gs^Fp, Gg, Gg, Cvr^Efm, Kvr, Cvr^Efm, Gg, Gg^Fet, Gg, Gs^Fp, Gg^Fet, Gg, Gg, Gg, Gg
Gs^Fp, Gs^Fp, Rd, Rd, Gg, Ww, Ww, Gs^Fet, Gs^Fet, Cv^Efm, Cv^Efm, Cv^Efm, Gs^Fet, Gs^Fet, Ww, Ww, Gg, Rd, Rd, Rd, Rd, Gg, Gg^Fet, Gg, Gg, Gs^Fp, Gs^Fp, Gs^Fp, Gg, Gg, Gg^Fet, Gg, Gs^Fp, Gg, Gg, Gg, Gg, Cvr^Efm, Gg, Gg, Gg, Gs^Fp, Gs^Fp, Gs^Fp, Gg, Gg^Efm, Gg, Gg
Gs^Fp, Gs^Fp, Gs^Fp, Gg^Ve, Gg^Efm, Gg, Gg^Fet, Ww, Ww, Gs^Fet, Gs^Fet, Gs^Fet, Ww, Ww, Gs^Fp, Gg, Gg, Gg, Gs^Fp, Gs^Fp, Gg, Gg^Ve, Gg, Gg, Gs^Fp, Gs^Fp, Gs^Fms, Gs^Fp, Gg, Gg^Fet, Gg, Gs^Fp, Gs^Fp, Gs^Fp, Gs^Fp, Gg^Efm, Gs^Fp, Gg, Gg, Gg, Gs^Fp, Gs^Fp, Gs^Fms, Gs^Fp, Gs^Fp, Gg, Gg, Gg
Gs^Fp, Gs^Fms, Gs^Fp, Gs^Fp, Gs^Fp, Gg, Gg, Gg, Gg, Ww, Ww, Ww, Gg, Gg, Gs^Fp, Gs^Fp, Gg, Gs^Fp, Gs^Fp, Gs^Fp, Gg, Gg, Gg, Gg, Gg, Gs^Fp, Gs^Fp, Gs^Fp, Gg, Gg, Gg, Gs^Fp, Gs^Fp, Gs^Fms, Gs^Fp, Gs^Fp, Gg, Gg, Gg, Gg, Gs^Fp, Gs^Fp, Gs^Fp, Gs^Fp, Gg, Gg, Gg, Gg
Gs^Fp, Gs^Fp, Gs^Fp, Gs^Fp, Gg, Gg, Gg, Gg, Gg, Gg, Gg, Gg, Gg, Gg, Gg, Gg, Gg, Gg, Gg, Gg, Gg, Gg, Gg, Gg, Gg, Gg, Gg, Gg, Gg, Gg, Gg, Gg, Gg, Gs^Fp, Gg, Gg, Gg, Gg, Gg, Gg, Gg, Gs^Fp, Gg, Gg, Gg, Gg, Gg, Gg
