Gg, Gg, Gg, Gg, Gg, Gg, Gg, Gg, Gg, Gg, Gg, Gg, Gg, Gg, Gg, Gg, Gg, Gg, Gg, Gg, Gg, Gg, Rr, Gg, Gg, Gg, Gg
Gg, Gg, Gg, Gg, Gg, Gg, Gs^Fp, Gs^Fp, Gs^Fp, Gg, Gg, Gg, Gg, Gg, Gg, Gg, Gg, Gg, Gg, Gg, Gg, Gg, Rr, Gg, Gg, Gg, Gg
Gg, Gg, Gg, Gg, Gs^Fp, Gs^Fp, Gs^Fms, Gs^Fp, Gs^Fp, Gg, Gg, Gg, Gg, Gg, Gs^Fp, Gs^Fp, Gg, Gg, Gg, Gg, Ch, Rr, Gg, Gg, Gg, Gg, Gg
Gg, Gg, Gg, Gs^Fp, Gs^Fp, Gg, Gs^Fp, Gs^Fp, Gs^Fms, Gs^Fp, Gs^Fp, Gg, Gg, Gg, Gs^Fp, Gs^Fp, Gs^Fp, Gg, Gg, Ch, 2 Kte, Ch, Gg, Gg, Gg, Gg, Gg
Gg, Gg, Gg, Gg, Gg, Gs^Fp, Gs^Fp, Gs^Fms, Gs^Fp, Gs^Fp, Gs^Fp, Gg, Gg, Gg, Gs^Fp, Gs^Fp, Gs^Fp, Gs^Fp, Gs^Fp, Ch, Ch, Ch, Gg, Gg, Gg, Gg, Gg
Gg, Gg, Gg, Gg, Gg, Gg, Gs^Fp, Gs^Fp, Gs^Fp, Gs^Fp, Gs^Fp, Gg, Gg, Gg, Gs^Fp, Gs^Fms, Gs^Fp, Gs^Fp, Gg, Rp, Gg, Gg, Gg, Gg, Gg, Gs^Vl, Gg
Gg, Gg, Gg, Gg, Gg, Gs^Fp, Gs^Fp, Gs^Fp, Gs^Fp, Gg, Hh, Hh, Gg, Gg, Gg, Gs^Fp, Gg, Gg, Rp, Rp, Gs^Fp, Gg, Gs^Fp, Gs^Fms, Gs^Fp, Gg, Gs^Fp
Gs^Fp, Gg, Gg, Gg, Gg, Gg, Gs^Fp, Gg, Gs^Fp, Gs^Fp, Hh, Hh^Fms, Hh, Gs^Vl, Gg, Gg, Rp, Rp, Gg, Gs^Fms, Gs^Fp, Gs^Fp, Gg, Gs^Fp, Gs^Fp, Gs^Fp, Gs^Fp
Gs^Fp, Gs^Fp, Gs^Fp, Gg, Gg, Gg, Gg, Gs^Fp, Gg, Hh^Fms, Hh, Mm, Mm, Hh, Rp, Rp, Gs^Fp, Gs^Fp, Gs^Fp, Gg, Gg, Gg, Gg, Hh, Hh^Fms, Gs^Fms, Gs^Fp
Gg, Gs^Fp, Gs^Fp, Gs^Fp, Gg, Gg, Gg, Gg, Gg, Hh, Hh, Mm, Mm, Hh, Rp, Gs^Fms, Gs^Fp, Gs^Fp, Gs^Fp, Gs^Fp, Gg, Gg, Hh, Hh, Hh, Gs^Fp, Gs^Fp
Gg, Gs^Fp, Gg, Gg, Gg, Gg, Gg, Gg, Gs^Fp, Hh, Hh^Fms, Mm, Mm, Hh, Rp, Gs^Fp, Gs^Fp, Gs^Fms, Gs^Fp, Gs^Fp, Gg, Hh^Fms, Hh, Mm, Mm, Hh, Gs^Fp
Ww, Gg, Ww, Gg, Gg, Gg, Gg, Gs^Fp, Gs^Fp, Gs^Fp, Gs^Fp, Hh, Hh, Hh, Rp, Gs^Fp, Gs^Fp, Gs^Fp, Gg, Gg, Gg, Hh, Hh^Fms, Mm, Mm, Hh, Gs^Fp
Wo, Ww, Wo, Ww, Wo, Ww, Ww, Ds, Ds, Gs^Fms, Gs^Fp, Gs^Fp, Hh, Gg, Rp, Gg, Gg, Gg, Gs^Fp, Gg, Gs^Fp, Hh, Mm, Mm, Mm, Hh, Hh
Wo, Wo, Wo, Wo, Wo, Wo, Wo, Ww, Ww, Ds, Gg, Gg, Gg, Gg, Rp, Gg, Gg, Gg, Gs^Fp, Gs^Fp, Gs^Fp, Hh^Fms, Mm, Mm, Hh^Fms, Hh, Gg
Gg, Wo, Ww, Ww, Gg, Wo, Wo, Wo, Gg, Wwr, Ww, Gg, Rp, Rp, Gs^Fp, Gg, Gg, Gg, Gs^Fp, Gs^Fp, Gs^Fp, Hh, Hh, Hh^Fms, Hh, Hh, Gg
Gg, Gg, Gg, Ww, Wwr, Gg, Wo, Wo, Wo, Gg, Ww, Gg, Rp, Mm, Gs^Fp, Gs^Fp, Gg, Gg, Gg, Gs^Fp, Gs^Fp, Gs^Fp, Gg, Gg, Gs^Fp, Gg, Gg
Gg, Gg, Gg, Ww, Ww, Gg, Ww, Wo, Wo, Wo, Wo^Bw/, Ww^Bw/, Wwr, Mm, Mm, Gs^Fp, Mm, Gg, Gg, Gs^Fp, Gs^Fp, Gg, Gg, Gg, Gs^Fp, Gs^Fms, Gs^Fp
Gg, Gg, Gg, Gg, Gg, Ww, Gs^Vl, Ww, Ww^Bw/, Wo^Bw/, Wo, Wo, Ww, Mm, Mm, Hh^Fms, Mm, Mm, Mm, Mm, Gg, Gg, Gg, Gs^Fp, Gs^Fms, Gs^Fp, Gs^Fp
Gg, Gg, Gs^Fp, Gs^Fms, Gs^Fp, Gg, Rp, Rp, Ss, Ww, Ww, Wo, Wo, Wwr, Mm, Mm, Mm, Mm, Mm, Mm, Mm, Mm, Gg, Gs^Fp, Gs^Fp, Gs^Fp, Gs^Fp
Gg, Gg, Gs^Fp, Gs^Fp, Gs^Fp, Gg, Rp, Ss, Ds, Ss, Ss, Ww, Wo, Ww, Ww, Wwr, Ww, Wwr, Ww, Mm, Mm, Mm, Gg, Gg, Gg, Gs^Fp, Gg
Gg, Gg, Gs^Fp, Gs^Fms, Gs^Fp, Gs^Fp, Rp, Gg, Ds, Ss, Gs^Fp, Ss, Ss, Wo, Wo, Wo, Wo, Wo, Wo, Ww, Ww, Ww, Ww, Ds, Ds, Ds, Gg
Gg, Gg, Gs^Fp, Gs^Fp, Gs^Fp, Gg, Rp, Gs^Fp, Gs^Fp, Gs^Fms, Gs^Fp, Gs^Fp, Gs^Fms, Gg, Ss, Wo, Ss, Ss, Ss, Wo, Wo, Wo, Wo, Ww, Ww, Ww, Ww
Gg, Gs^Fp, Gs^Fms, Gs^Fp, Rp, Rp, Gg, Gg, Gs^Fp, Gs^Fp, Gs^Fms, Gs^Fp, Ss, Ss, Ss, Ss, Gg, Gg, Gg, Ds, Ds, Wo, Wo, Wo, Wo, Ww, Ww
Gg, Gg, Rp, Rp, Gg, Rp, Rp, Ss, Ss, Ss, Ss, Ss, Gg, Gg, Gg, Gg, Gg, Gg, Gg, Gg, Gg, Ww, Ww, Wo, Wo, Wo, Wo
Rp, Rp, Gs^Fp, Gg, Ss, Gg, Ss, Ss^Bw\, Rp, Gg, Gg, Gg, Gg, Gg, Gg, Gg, Gs^Fp, Gs^Fms, Gs^Fp, Gs^Fms, Gs^Fp, Gg, Ww, Ww, Ww, Wo, Wo
Gg, Gg, Ss, Ss, Ss, Ss, Gs^Fms, Gs^Fp, Gg, Rp, Gg, Gg, Gg, Gg, Gs^Fms, Gs^Fp, Gs^Fms, Gs^Fp, Gs^Fms, Gs^Fp, Gs^Fp, Gg, Ww, Gg, Gg, Ww, Ww
Ss, Ss, Ss, Gs^Fp, Gs^Fp, Gs^Fp, Gs^Fp, Gs^Fp, Gg, Rp, Gs^Fp, Gs^Fp, Gs^Fp, Gg, Gg, Gs^Fp, Ce, Ce, Ce, Gs^Fp, Gg, Gg, Gg, Ww, Ww, Ww, Ds
Gg, Gg, Gg, Gg, Gg, Gs^Fms, Gg, Gs^Fp, Gs^Fp, Rp, Rp, Gs^Fms, Gs^Fp, Gg, Gg, Gg, Ce, Ke, Ce, Gg, Gg, Gg, Gg, Gg, Gg, Ds, Gg
Gg, Gg, Gg, Gg, Gg, Gg, Gg, Gg, Gg, Gg, Gs^Fp, Rp, Rp, Gg, Gs^Fp, Gg, Gg, Ce, Gs^Fms, Gs^Fp, Gs^Fp, Gs^Vc, Gg, Gg, Gs^Fp, Gg, Gg
Gg, Gg, Gg, Gg, Gs^Fp, Gg, Gs^Fp, Gs^Fp, Gs^Fp, Gs^Fms, Gs^Fp, Gg, 1 Rp, Gs^Fms, Gs^Fp, Gg, Gg, Gs^Fp, Gs^Fp, Gs^Fp, Gs^Fp, Gg, Gg, Gg, Gs^Fms, Gg, Gg
Gg, Gs^Fp, Gs^Fms, Gs^Fms, Gs^Fp, Gs^Fp, Gg, Gs^Fp, Gs^Fms, Gg, Gg, Gg, Rp, Gs^Fp, Gs^Fp, Gg, Gg, Gs^Fp, Gs^Fp, Gs^Fms, Gg, Gs^Fp, Gg, Gg, Gs^Fp, Gs^Fp, Gs^Fms
Gg, Gs^Fp, Gg, Gg, Gs^Fp, Gg, Gs^Fp, Gg, Gg, Gg, Gg, Gg, Rp, Gs^Fp, Gs^Fms, Gg, Gg, Gg, Gg, Gs^Fp, Gs^Fp, Gg, Gg, Gg, Gs^Fms, Gg, Gs^Fp
Gg, Gg, Gg, Gg, Gg, Gs^Fp, Gg, Gs^Fp, Gg, Gg, Gg, Gs^Fp, Rp, Gg, Gs^Fp, Gs^Fp, Gg, Gg, Gg, Gg, Gg, Gg, Gg, Gg, Gg, Gs^Fp, Gs^Fp
Gg, Gg, Gg, Gg, Gg, Gg, Gg, Gg, Gg, Gg, Gg, Gg, Rp, Gg, Gg, Gg, Gg, Gg, Gs^Fp, Gg, Gs^Fp, Gg, Gg, Gg, Gg, Gs^Fms, Gg
Gg, Gg, Gs^Fms, Gg, Gg, Gg, Gg, Gg, Gg, Gg, Gg, Gg, Rp, Gg, Gg, Gg, Gs^Fp, Gs^Fp, Gs^Fp, Gs^Fp, Gs^Fp, Gg, Gg, Gg, Gs^Fp, Gg, Gg
Gs^Fp, Gs^Fp, Gs^Fp, Gs^Fp, Gs^Fp, Gg, Gs^Fp, Gg, Gg, Gg, Gg, Gg, Rp, Gg, Gs^Fp, Gs^Fp, Gs^Fms, Gs^Fp, Gs^Fp, Gs^Fms, Gs^Fp, Gs^Fp, Gs^Fp, Gs^Fp, Gs^Fms, Gs^Fp, Gs^Fp
Gs^Fp, Gs^Fp, Gs^Fp, Gs^Fp, Gs^Fp, Gs^Fp, Gs^Fp, Gs^Fp, Gg, Gg, Gg, Gg, Rp, Gg, Gs^Fp, Gs^Fp, Gs^Fp, Gs^Fp, Gs^Fp, Gs^Fms, Gg, Gs^Fp, Gg, Gs^Fp, Gs^Fp, Gs^Fp, Gg
Gs^Fp, Gs^Fp, Gs^Fp, Gs^Fp, Gs^Fp, Gs^Fp, Gs^Fp, Gg, Gg, Gg, Gg, Gg, Rp, Gg, Gg, Gs^Fp, Gs^Fp, Gs^Fp, Gg, Gg, Gg, Gg, Gg, Gg, Gg, Gg, Gg
