Gg^Fms, Gg^Fms, Hh^Fms, Hh, Hh^Fms, Hh^Fms, Hh, Hh^Fms, Hh^Fms, Hh^Fms, Hh^Fms, Hh, Hh^Fms, Hh, Hh^Fms, Hh, Hh^Fms, Hh, Hh^Fms, Hh^Fms, Hh^Fms, Hh, Mm, Mm, Mm, Mm, Mm, Mm, Hh, Hh, Gg, Gg, Gs^Fds, Gs^Fds, Gs^Fds, Gg, Re, Rp, Re, Re, Gg, Hh, Hh, Hh, Gg, Gg, Gg, Gg, Hh^Fds, Gg^Fds, Gs^Fds, Gs^Fds, Gs^Fds, Gg^Fds, Gg^Fds, Gg^Fds, Gg^Fds, Gg^Fds, Gg^Fds, Gg^Fds
Hh, Hh^Fms, Hh^Fms, Hh^Fms, Hh^Fms, Hh^Fms, Hh, Hh, Hh, Hh^Fms, Hh, Hh^Fms, Hh^Fms, Hh^Fms, Hh^Fms, Hh, Hh, Hh, Hh^Fms, Hh^Fms, Hh^Fms, Hh, Mm, Mm, Mm, Mm, Mm, Hh, Mm, Hh, Gg, Gg, Gg, Gs^Fds, Gg, Gg, Re, Rp, Re, Re, Gg, Hh, Hh^Fms, Hh, Hh, Gg, Hh, Hh^Fds, Hh, Hh^Fds, Gg, Gg^Fds, Mm, Gg^Fds, Gg, Gg^Fds, Mm, Gg^Fds, Gg^Fds, Gg^Fds
Hh^Fms, Hh^Fms, Hh^Fms, Hh^Fms, Hh, Hh, Hh, Hh, Mm, Hh, Hh, Hh, Hh, Hh, Hh, Hh, Mm, Hh, Hh, Hh, Mm, Mm, Mm, Mm, Mm, Hh, Hh, Mm, Hh, Hh, Gg, Gg, Gg, Gg, Gg, Gg, Re, Rp, Re, Re, Gg, Hh, Hh, Hh, Hh, Gg, Hh, Hh, Mm, Mm, Mm, Mm, Mm, Mm, Mm, Mm, Mm, Gg^Fds, Gg^Fds, Gg^Fds
Hh^Fms, Hh^Fms, Hh^Fms, Hh, Hh, Hh, Mm, Hh, Mm, Hh, Co, Hh^Vc, Co, Mm, Hh, Mm, Mm, Hh, Hh^Vhh, Mm, Mm, Mm, Mm, Hh, Hh, Hh, Mm, Hh, Mm, Mm, Mm, Gg, Hh, Gg, Hh, Hh, Re, Rp, Re, Re, Gg^Vc, Mm, Hh, Hh, Hh, Mm, Mm, Mm, Mm, Mm, Mm, Mm, Mm, Mm, Mm, Gs, Mm, Hh^Fds, Mm, Gg
Hh^Fms, Hh^Fms, Hh, Mm, Hh, Mm, Mm, Hh, Hh^Fms, Hh, Co, Co, Co, Hh, Hh, Hh, Hh, Hh, Hh, Hh, Hh, Mm, Mm, Mm, Hh, Mm, Gs^Fms, Mm, Mm, Mm, Mm, Mm, Hh, Hh^Fms, Re, Re, Rp, Rp, Re, Re, Hh, Mm, Hh, Hh, Hh, Hh, Mm, Mm, Gs^Fms, Mm, Mm, Mm, Mm, Mm^Vc, Mm, Mm, Chr, Hh, Hh, Gg
Hh, Hh^Fms, Hh^Fms, Mm, Hh, Mm, Mm, Hh, Hh, Co, Co, 2 Ko, Co, Co, Hh, Mm, Mm, Hh, Hh, Hh, Hh, Mm, Hh, Mm, Hh, Hh^Fms, Hh, Mm, Mm, Mm, Gs, Hh^Fds, Re, Re, Re, Re, Re, Re, Re, Hh, Hh, Hh, Hh^Fms, Hh, Hh, Mm, Hh, Mm, Mm, Gs, Mm, Mm, Mm, Mm, Hh, Cer, Chr, Hh, Cer, Gg
Mm, Hh, Hh, Hh, Mm, Gg, Hh, Hh, Hh, Hh, Co, Co, Co, Hh, Hh, Hh, Mm, Hh, Hh, Mm, Hh, Hh, Mm, Hh, Hh^Vc, Hh, Hh, Hh, Gg, Gs^Fds, Re, Re, Re, Re, Re, Re, Re, Re, Mm, Hh, Hh, Hh^Fms, Hh^Fms, Hh, Hh, Mm, Hh, Mm, Mm, Mm, Mm, Mm, Mm, Mm, Cer, Cer, 3 Ker, Cer, Cer, Cer
Hh, Mm, Hh, Hh, Mm, Hh, Mm, Hh, Mm, Mm, Hh, Hh, Hh, Hh, Mm, Mm, Hh, Hh, Hh, Hh, Mm, Mm, Hh, Hh, Hh, Hh^Fms, Hh, Hh, Re, Re, Re, Re, Re, Re, Re, Re, Gg, Mm, Mm, Hh, Hh, Hh, Hh, Hh, Hh, Mm, Mm, Mm, Mm, Mm, Mm, Mm, Gg, Mm, Chr, Chr, Cer, Chr, Cer, Hh
Mm, Hh, Mm, Mm, Hh, Hh, Hh^Vc, Hh, Mm, Mm, Mm, Hh, Hh, Mm, Hh, Mm, Hh, Hh^Fms, Gg, Hh, Mm, Mm, Hh, Hh, Hh, Hh, Re, Re, Re, Re, Re, Rp, Re, Re, Gg, Gg, Hh, Hh, Hh, Gs^Fms, Hh, Hh, Hh^Fms, Hh, Gs^Fp, Mm, Gs^Fp, Hh^Fms, Gs^Fp, Hh, Gg, Hh, Hh, Hh^Vc, Mm, Cer, Cer, Hh, Gg, Gg
Mm, Hh, Mm, Hh, Mm, Hh, Mm, Hh, Hh, Hh, Hh, Hh, Hh, Mm, Hh, Hh, Hh, Hh, Mm, Mm, Hh, Hh, Gg, Gg, Gg, Re, Re, Re, Re, Re, Re, Re, Gg, Gg, Gg, Hh, Gs^Fp, Hh, Hh, Mm, Gs^Fp, Gs^Fp, Gs^Fp, Gs^Fp, Gs^Fp, Gs^Fp, Gs^Fp, Gs^Fms, Gs^Fp, Gs^Fp, Gs^Fp, Gg, Hh, Hh, Mm, Gg, Mm, Mm, Hh, Mm
Mm, Mm, Hh, Mm, Mm, Mm, Mm, Mm, Mm, Hh, Mm, Mm, Hh, Hh, Hh, Hh, Mm, Mm, Mm, Mm, Hh, Gg, Gs^Fds, Gg, Re, Re, Re, Re, Re, Re, Hh, Gg, Gg, Gg, Gg, Gs^Fp, Gs^Fms, Gs^Fp, Gs^Fp, Gs, Gs^Fp, Gs^Fp, Gs^Fp, Gs^Fp, Gs^Fp, Gs^Fp, Gs^Fp, Gs^Fp, Gs^Fp, Gg, Gs^Fp, Gs^Fp, Hh, Mm, Mm, Mm, Mm, Hh, Hh, Gg
Mm, Hh, Hh, Mm, Mm, Mm, Mm, Mm, Hh, Mm, Hh, Hh, Hh, Mm, Hh, Mm, Mm, Mm, Mm, Mm, Gg, Gg, Re, Re, Re, Re, Re, Gg, Gg, Hh, Hh, Hh, Gg, Gg^Ve, Gg, Gs^Fp, Gs^Fp, Gs^Fp, Gs^Fms, Gs^Fp, Gs^Fp, Gs^Fp, Gs^Fp, Gs^Fms, Gs^Fms, Gs^Fp, Gs^Fp, Gs^Fms, Gs^Fp, Gs^Fp, Hh, Hh, Hh, Mm, Mm, Mm, Mm, Mm, Hh, Gg
Mm, Hh, Mm, Mm, Mm, Mm, Mm, Hh, Hh, Mm, Hh, Hh^Fms, Ss, Ds, Ss, Hh, Hh, Hh, Gg, Gg, Re, Re, Re, Re, Rp, Rp, Re, Gg, Gg, Gg, Gg, Hh, Hh, Gg, Gg, Gg, Gg, Gs^Fp, Gs^Fp, Gs^Fms, Gs^Fp, Gs^Fp, Gg^Fet, Gs^Fp, Gs^Fp, Gs^Fp, Gs^Fp, Gs^Fp, Gs^Fp, Hh, Gg^Ve, Hh, Hh, Mm, Mm, Hh^Fms, Mm, Mm, Mm, Gg
Wwf, Wwf, Wwf, Mm, Wwf, Mm, Wwf, Mm, Ww^Bw|, Hh, Wwf, Ss, Wwf, Ss, Ss, Ds, Ds, Hh, Re, Re, Re, Rp, Rp, Rp, Re, Re, Mm, Mm, Hh, Gg, Gg, Gg, Hh, Hh, Gg, Gs^Fp, Gs^Fms, Gg, Gg, Gs^Fp, Gs^Fp, Gs^Fp, Gs^Fp, Gs^Fp, Gs^Fp, Gs^Fp, Gs^Fp, Gs^Fp, Mm, Mm, Gg, Hh, Hh, Mm, Mm, Mm, Mm, Mm, Mm, Gg
Gg, Gg, Mm, Wwf, Hh, Wwf, Hh, Wwf, Rd, Wwf, Hh, Wwf, Ds, Ss, Ss, Ss, Re, Re, Re, Re, Re, Re, Re, Re, Mm, Mm, Mm, Mm, Mm, Hh, Hh, Gg, Gg, Hh, Hh, Gs^Fp, Hh, Gs^Fp, Gs^Fp, Gg, Gg, Gs^Fp, Gg, Gs^Fp, Gs^Fp, Gs, Mm, Mm, Mm, Mm, Gg, Hh, Hh, Mm, Hh, Mm, Mm, Mm, Hh, Hh
Gg, Mm, Mm, Mm, Mm, Hh, Hh, Hh, Rd, Hh, Hh^Vhh, Hh, Ss, Ss, Ss, Ds, Re, Re, Re, Re, Re, Re, Gg, Gg, Mm, Mm, Mm, Mm, Mm, Mm, Mm, Gg, Hh, Hh, Mm, Hh, Hh, Gs^Fms, Hh, Hh, Gs^Fms, Gg, Gg, Gg, Gg, Gg^Ve, Hh, Mm, Gg, Gg, Mm, Hh, Hh, Hh, Mm, Hh, Hh, Mm, Mm, Hh
Gg, Mm, Mm, Mm, Hh, Hh, Hh^Fms, Hh, Hh, Gg, Gg, Gg, Gg, Gg, Gg, Gg, Gs^Fds, Re, Re, Re, Re, Gg, Mm, Mm, Mm, Mm, Mm, Mm, Mm, Mm, Gg, Gg, Gg, Mm, Mm, Mm, Hh, Hh, Hh, Hh^Fms, Hh, Gs^Fms, Hh, Mm, Mm, Gg, Gg, Gg, Mm, Mm, Mm, Mm, Mm, Mm, Hh, Hh, Mm, Hh^Fms, Hh, Hh
Gg, Mm, Hh, Mm, Hh, Hh, Hh, Hh, Gg, Gg, Hh, Hh, Mm, Gg, Gg, Gs, Re, Re, Rp, Re, Re, Gg, Gg^Ve, Gg, Mm, Mm, Mm, Mm, Gg, Gg, Mm, Gg, Mm, Mm, Mm, Mm, Hh, Hh, Hh, Hh, Mm, Hh, Hh^Fms, Hh, Mm, Hh, Hh, Gg, Mm, Mm, Mm, Mm, Mm, Mm, Mm, Mm, Hh^Fms, Mm, Hh, Hh
Gg, Hh, Mm, Hh, Hh, Hh, Hh, Gg, Hh, Hh, Hh, Hh, Mm, Hh, Gg, Gg, Re, Rp, Re, Re, Gg, Gg, Mm, Mm, Mm, Mm, Mm, Gg, Gg, Mm, Mm, Mm, Mm, Mm, Mm, Mm, Hh, Hh^Fms, Hh, Mm, Mm, Hh, Hh, Hh, Mm, Mm, Mm, Gg, Hh, Gs^Fms, Mm, Mm, Mm, Hh, Hh, Hh, Hh, Mm, Hh^Fms, Hh
Mm, Hh, Hh, Hh, Gg, Gg, Hh, Hh, Hh^Fds, Hh, Mm, Mm, Mm, Hh, Gg, Gg, Re, Re, Rp, Re, Gg, Mm, Mm, Mm, Mm, Mm, Gg, Gg, Mm, Mm, Mm, Mm, Mm, Mm, Hh, Hh, Hh, Hh, Hh, Mm, Mm, Mm, Mm, Mm, Hh, Mm, Hh, Gg, Gg, Mm, Mm, Hh^Fms, Hh, Mm, Mm, Hh, Hh, Mm, Hh, Hh
Hh, Hh, Cer, Cer, Cer, Hh, Mm, Hh, Hh, Mm, Mm, Mm, Mm, Hh, Gg, Gg, Re, Re, Re, Re, Gg, Gg, Mm, Mm, Mm, Gg, Mm, Gg, Gg, Gg, Gg, Mm, Hh, Hh, Hh, Hh^Vhh, Hh, Hh, Mm, Mm, Mm, Mm, Hh, Mm, Mm, Mm, Mm, Mm, Gg, Mm, Hh, Hh, Mm, Mm, Hh, Mm, Hh, Hh, Hh, Hh
Mm, Mm, Co, 6 Ker, Cer, Mm, Mm, Hh, Hh, Hh, Hh, Mm, Hh^Fds, Hh, Gg, Gg, Re, Re, Re, Re, Gg, Mm, Mm, Mm, Mm, Mm, Mm, Mm, Mm, Gg, Hh, Gg, Mm, Hh, Hh, Mm, Mm, Mm, Mm, Mm, Mm, Hh, Hh, Hh, Mm, Hh, Gg, Gg, Gg, Mm, Hh^Fms, Mm, Mm, Mm, Hh^Fms, Mm, Mm, Hh, Mm, Hh
Hh, Mm, Hh, Cer, Hh^Ecf, Gg, Gg, Gg, Gg, Gg, Hh, Hh, Gg, Hh, Gg, Mm, Re, Re, Re, Re, Gg, Mm, Mm, Mm, Mm, Mm, Mm, Mm, Hh, Hh, Hh, Gg, Mm, Hh, Gs^Fms, Mm, Mm, Mm, Mm, Mm, Mm, Hh, Mm, Hh, Mm, Mm, Gg, Gg, Gg^Vhr, Mm, Mm, Hh, Mm, Mm, Mm, Mm, Hh, Hh, Mm, Mm
Mm, Hh, Mm, Hh, Hh, Gg, Gg, Gg, Gg, Gg, Gg, Gg, Gg, Gg, Mm, Gg, Re, Re, Re, Re, Hh, Mm, Mm, Mm, Mm, Mm, Mm, Mm, Hh, Hh^Fms, Mm, Gg, Mm, Mm, Mm, Mm, Mm, Mm, Mm, Mm, Mm, Hh, Hh, Hh, Gg, Gg, Hh, Mm, Hh, Hh, Mm, Mm, Mm, Mm, Chr, Chr, Chr, Hh, Hh, Mm
Mm, Hh, Hh, Mm, Gg, Hh^Vc, Hh, Gg, Gg, Gg, Gg, Gg, Gg, Gg, Gg^Vl, Gg, Re, Re, Rp, Re, Hh, Mm, Mm, Mm, Mm, Mm, Mm, Mm, Mm, Hh, Hh, Gg, Mm, Mm, Mm, Mm, Mm, Mm, Mm, Mm, Mm, Hh, Hh, Gg, Hh, Hh, Hh, Hh, Mm, Hh, Mm, Mm, Mm, Chr, Chr, 4 Ker, Chr, Chr, Mm, Hh
Mm, Hh, Hh, Mm, Gg, Mm, Hh, Mm, Mm, Gg, Gg, Gg, Gg, Gg, Gg, Gg, Re, Re, Re, Re, Re, Mm, Mm, Mm, Mm, Hh, Hh, Mm, Gg, Hh^Vc, Gg, Gg, Mm, Mm, Mm, Mm, Mm, Mm, Mm, Mm, Mm, Mm, Mm, Gg, Gg, Mm, Mm, Mm, Mm, Mm, Mm, Mm, Mm, Chr, Mm, Chr, Mm, Hh^Fms, Hh, Hh
Hh, Hh, Hh, Gg, Gg, Gg, Gg, Gg, Gg, Mm, Gg, Gg, Gg, Gg, Gg, Gg, Re, Re, Re, Re, Mm, Mm, Mm, Mm, Hh^Fms, Hh^Fms, Hh^Fms, Hh, Hh, Gg, Hh, Mm, Hh, Mm, Mm, Mm, Hh^Fms, Mm, Hh, Hh^Fms, Hh, Mm, Hh, Gg, Gg, Hh, Mm, Hh, Mm, Mm, Mm, Hh, Hh, Hh, Hh^Fms, Mm, Mm, Hh, Mm, Mm
Hh, Hh, Hh^Fds, Hh, Gg, Gg, Gg, Gg, Gg, Gg, Gg, Gg, Gg, Gg, Re, Re, Rp, Re, Re, Re, Mm, Mm, Mm, Mm, Mm, Hh^Fms, Hh, Mm, Gg, Gg, Hh, Hh, Mm, Hh, Hh, Hh, Hh^Fms, Hh^Fms, Hh^Fms, Hh, Hh, Hh, Hh^Fms, Hh, Gg, Hh, Hh, Hh, Mm, Mm, Mm, Hh, Hh, Hh^Vhh, Mm, Mm, Hh, Mm, Mm, Hh
Mm, Mm, Hh, Hh, Gg, Gg, Gg, Gg, Gg, Gg, Gg, Gg, Re, Re, Re, Rp, Re, Re, Hh, Hh, Hh^Fms, Mm, Mm, Mm, Mm, Hh, Hh, Hh, Gg, Hh, Hh, Hh, Hh, Hh, Hh, Hh, Hh, Hh^Fms, Hh, Hh, Mm, Hh, Hh, Hh, Mm, Gg, Hh, Mm, Hh, Hh, Hh, Hh, Hh, Hh, Hh, Hh, Hh, Hh, Hh, Hh
Gs^Fds, Hh, Hh^Vc, Hh, Gg, Gg, Gs^Fds, Gs^Fds, Gs, Gg, Re, Re, Re, Re, Re, Re, Re, Re, Re, Hh, Hh, Mm, Mm, Mm, Gg, Mm, Mm, Gg, Hh, Hh, Hh, Mm, Hh, Hh, Gg, Gg^Ve, Gg, Hh, Mm, Mm, Gs^Fms, Mm, Mm, Mm, Mm, Gg, Gg, Hh, Hh^Fms, Hh, Hh, Hh^Fms, Hh, Hh, Hh, Hh, Hh, Hh, Re, Re
Gs^Fds, Hh, Hh, Gg, Gg, Gg, Gg, Gs^Fds, Re, Re, Re, Re, Re, Re, Gg, Gg, Hh, Re, Re, Re, Re, Hh, Hh, Hh, Hh, Mm, Mm, Gg, Hh, Mm, Hh, Hh, Gg, Re, Re, Re, Re, Hh, Re, Mm, Hh, Gg, Hh, Mm, Hh, Hh, Gg, Hh, Hh, Hh, Re, Hh, Re, Hh, Re, Re, Re, Re, Hh, Hh
Gg, Gg, Hh, Gs^Fds, Gg, Gg, Gg, Re, Re, Re, Re, Re, Re, Re, Ch, Hh, Hh, Hh, Gg, Re, Hh, Re, Re, Mm, Re, Hh, Re, Gg, Re, Hh, Re, Hh, Re, Re, Hh, Hh, Hh, Re, Gg, Re, Re, Re, Re, Re, Re, Re, Re, Re, Re, Re, Hh, Re, Hh, Re, Hh, Hh, Hh, Hh, Hh, Hh
Mm, Mm, Mm, Gg, Gg, Gg, Re, Re, Rp, Re, Re, Re, Re, Ch, Kh, Hh^Fms, Hh, Mm^Vhhr, Mm, Mm, Mm, Gg, Gg, Re, Gg, Re, Gg, Re, Gg, Re, Hh, Re, Hh, Hh, Hh, Hh^Fms, Hh, Hh, Hh, Hh, Hh, Gg, Hh, Hh, Hh^Fds, Hh, Hh, Hh, Gg, Gg, Hh, Hh, Hh, Hh, Hh^Fms, Hh^Fms, Hh^Fms, Hh, Hh, Hh
Mm, Mm, Mm, Gg, Gg, Gg, Re, Re, Rp, Re, Gg, Re, Re, Ch, Hh, Hh, Mm, Mm, Mm, Mm, Mm, Mm, Mm, Gg, Gg, Hh, Gg, Gg, Gg, Hh, Hh, Hh, Hh, Hh, Hh, Hh, Hh, Hh^Vhh, Hh, Hh, Gg, Hh, Mm, Hh, Hh, Hh, Mm, Gg, Gg, Gg, Gg, Hh, Gg, Hh, Hh, Hh^Fms, Hh, Hh, Gg, Gg
Gg, Mm, Gg, Gg, Gg, Gg, Re, Re, Rp, Re, Mm, Hh, Hh^Fms, Hh, Mm, Mm, Mm, Mm, Mm, Mm, Mm, Mm, Mm, Gg, Gg, Hh, Gg, Mm, Mm, Hh, Hh, Hh, Chr, Chr, Chr, Chr, Hh, Hh, Hh, Hh, Gg, Gg, Gg, Mm, Mm, Mm, Gg, Gg, Gg, Gg, Gg, Gg, Gg, Gg, Gg, Gg, Gg, Hh, Gg, Gg
Gs^Fds, Gg, Mm, Mm, Mm, Gg, Re, Re, Rp, Re, Mm, Mm, Mm, Mm, Mm, Mm, Mm, Mm, Mm, Mm, Gs^Fds, Mm, Gg, Mm, Gg, Gg, Gg, Hh^Fms, Hh, Hh, Hh, Chr, Chr, 5 Ker, Chr, Hh^Fet, Chr, Hh, Mm, Gg, Gg, Gg, Gg, Mm, Mm, Mm, Gg, Hh, Hh, Hh, Wwf, Wwf, Wwf, Wwf, Wwf, Gg, Gg, Gg, Gg, Gg
Gg, Gg, Mm, Mm, Mm, Gg, Re, Re, Re, Re, Hh, Mm, Mm, Mm, Mm, Mm, Mm, Mm, Mm, Gs^Fds, Gg, Gg, Gg, Gg, Gg, Gg, Hh, Hh, Hh, Hh^Vc, Hh, Hh, Chr, Chr, Chr^Fds, Chr^Fds, Hh, Hh, Hh, Gg, Gg, Gg, Hh, Mm, Mm, Mm, Gg, Hh, Hh, Hh, Wwf, Wwf, Ww, Wwf, Wwf, Gg, Gg, Gg^Vhr, Gg, Gg
Mm, Mm, Mm, Mm, Gg, Gg, Re, Re, Re, Re, Gg, Hh, Mm, Mm, Mm, Mm, Mm, Mm, Mm, Mm, Mm, Gg, Mm, Gg, Gg, Gg, Gg, Hh, Hh, Hh, Hh, Hh, Hh, Hh, Hh, Hh^Fds, Hh, Hh, Hh, Gg, Gg, Hh, Hh, Hh, Hh, Gg, Gg, Hh, Hh, Wwf, Hh, Ww, Ww, Ww, Ww, Wwf, Wwf, Gg, Gg, Gg
Mm, Mm, Gg^Fet, Gg, Gg, Gg, Re, Re, Re, Re, Gg, Hh, Mm, Mm, Mm, Mm, Gg, Gg, Mm, Mm, Mm, Mm, Mm, Mm, Gg, Gg, Gg, Gg, Gg, Hh, Gg, Gg, Gg, Gg, Gg, Hh, Hh, Hh, Gg, Gg, Hh, Hh, Hh, Hh, Hh, Mm, Gg, Hh, Hh, Hh, Hh, Hh, Hh, Wwf, Wwf, Wwf, Wwf, Gg, Gg, Gg
Gs^Fds, Gs^Fds, Gs^Fds, Gg, Gs^Fds, Gg, 1 Re, Re, Re, Re, Gg, Gg, Gg, Hh, Gg, Gg, Gg^Vhr, Gg, Gg, Mm, Gg, Gg, Gg, Gs^Fms, Gg, Gg, Gg, Gg, Gg, Gg, Gg, Gg, Gg, Gg, Gg, Gg, Gg, Hh, Gg, Gg, Gg, Hh, Gg, Hh, Gg, Mm, Gg, Hh, Hh, Hh, Hh, Hh, Gg, Hh, Wwf, Wwf, Hh, Gg, Gg, Gg
Gg, Gg, Gg, Gg, Gg, Gg, Re, Re, Re, Re, Gg, Gg, Hh, Hh^Fds, Gg, Gg, Gg, Gg, Gg, Gg, Gg, Gg, Gg, Gg, Gg, Gg, Gg, Gg, Gg, Gg, Gg, Gg, Gg, Gg, Gg, Gg, Gg, Gg, Gg, Gg, Gg, Gg, Gg, Gg, Gg, Gg, Gg, Gg, Gg, Gg, Gg, Gg, Gg, Gg, Gg, Hh, Hh, Hh, Gg, Gg
Gg, Gg, Hh, Gg, Gg, Re, Re, Re, Re, Re, Gg, Gg, Hh, Hh, Hh, Gg, Gg, Gg, Gg, Gg, Gg, Gg, Gg, Gg, Gg, Gg, Gg, Gg, Gg, Gg, Gg, Gg, Gg, Gg, Gg, Gg, Gg, Gg, Gg, Gg, Gg, Gg, Gg, Gg, Gg, Gg, Gg, Gg, Gg, Gg, Gg, Gg, Gg, Gg, Gg, Gg, Gg, Gg, Gg, Gg
