Ww^Bw\, Wo, Wo, Wo, Wo, Wo, Wo, Wo, Wo, Wo, Ww, Ww, Ww, Wo, Ss, Ss, Ss, Wo, Ww
Wo, 2 Ww^Bw\, Ww^Bw\, Wo, Wo, Wo, Wo, Wo, Wo, Wo, Wo, Wo, Wo, Ww, Ss, Ss, Ss, Ss, Ss
Wo, Wo, Wo, Ww^Bw\, Ww^Bw\, Wo, Ww, Ww, Gs^Fms, Ww, Ww, Wo, Wo, Wo, Ww, Ss, Ww, Ss, Ss
Wo, Wo, Wo, Wo, Wo, Ww^Bw\, Ww^Bw\, Gs^Fms, Gg^Ve, Gs^Fms, Gs^Fms, Wo, Wo, Wo, Wo, Ww, Ww, Ss, Ss
Wo, Wo, Wo, Wo, Ww, Wo, Ww, Ww^Bw\, Ww^Bw\, Gg^Fet, Gg^Ve, Wo, Wo, Wo, Wo, Wo, Ww, Ww, Ss
Wo, Wo, Ww, Ww, Wo, Ww, Wo, Wo, Wo, Ww^Bw\, Ww^Bw\, Wo, Wo, Wo, Wo, Wo, Wo, Ww, Wo
Wo, Wo, Ww, Wo, Wo, Wo, Wo, Wo, Ww, Wo, Wo, Ww^Bw\, Ww^Bw\, Wo, Wo, Wo, Wo, Ww, Wo
Wo, Wo, Wo, Ww, Ww, Wo, Wo, Ww, Ww, Ww, Ww, Wo, Wo, Ww^Bw\, Ww^Bw\, Wo, Wo, Wo, Wo
Wo, Wo, Ww, Wo, Wo, Ww, Wo, Wo, Wo, Ww, Ww, Ww, Ww, Wo, Wo, Ww^Bw\, Ww^Bw\, Wo, Wo
Wo, Ww, Wo, Ww, Ww, Ww, Ww, Ww, Ww, Wo, Ww, Ww, Ww, Ww, Ww, Wo, Wo, Ww^Bw\, Ww^Bw\
Wo, Ww, Wo, Ww, Wo, Ww, Ww, Ww, Ss, Ww, Ss, Ww, Wo, Ww, Wo, Wo, Wwr, Ww, Wo
Ww, Ww, Wo, Ww, Ww, Wo, Wo, Ww, Ww, Ss, Ss, Ww, Ww, Wo, Ww, Ww, Wo, Wo, Wo
Ss, Wo, Ww, Wo, Ww, Ww, Ww, Wo, Ww, Ww, Ww, Ww, Ww, Ww, Wo, Wo, Wo, Wo, Wo
Wo, Ss, Ss, Ss, Ss, Ww, Ww, Ww, Wo, Ww, Ww, Ww, Ww, Ww, Ww, Wo, Wo, 1 Wo, Wo
Ss, Ss, Ss, Ss, Ss, Ss, Ss, Ss, Ww, Ww, Ww, Ww, Wo, Ww, Ww, Ww, Ww, Wo, Wo
